year,migration_type,primary_FIPS,primary_county,aux_FIPS,aux_county,aux_state,aux_GeoRollup,people_inflow,agi_inflow,agi_capita_inflow,people_outflow,agi_outflow,agi_capita_outflow,people_net,agi_net
2016,county,48453,Travis,16001,Ada,ID,Rural Idaho,52,2515000,48365.38461538462,96,2646000,27562.5,-44,-131000
2016,county,48029,Bexar,16001,Ada,ID,Rural Idaho,55,844000,15345.454545454546,86,2081000,24197.674418604653,-31,-1237000
2016,county,48453,Travis,08001,Adams,CO,Denver,85,1848000,21741.176470588234,129,3529000,27356.58914728682,-44,-1681000
2016,county,48029,Bexar,08001,Adams,CO,Denver,68,1981000,29132.352941176472,130,3422000,26323.076923076922,-62,-1441000
2016,county,48453,Travis,12001,Alachua,FL,Rural Florida,70,2050000,29285.714285714286,197,3233000,16411.167512690354,-127,-1183000
2016,county,48491,Williamson,06001,Alameda,CA,Bay Area,190,8398000,44200.0,60,3545000,59083.333333333336,130,4853000
2016,county,48453,Travis,06001,Alameda,CA,Bay Area,479,23486000,49031.31524008351,477,21814000,45731.656184486375,2,1672000
2016,county,48029,Bexar,06001,Alameda,CA,Bay Area,122,3947000,32352.45901639344,74,3232000,43675.67567567567,48,715000
2016,county,48453,Travis,36001,Albany,NY,Rural New York,44,1919000,43613.63636363636,47,2627000,55893.617021276594,-3,-708000
2016,county,48453,Travis,51510,Alexandria city,VA,D.C.,63,3720000,59047.619047619046,65,2892000,44492.307692307695,-2,828000
2016,county,48029,Bexar,51510,Alexandria city,VA,D.C.,72,4442000,61694.444444444445,48,2414000,50291.666666666664,24,2028000
2016,county,48453,Travis,42003,Allegheny,PA,Pittsburgh,200,8249000,41245.0,175,4236000,24205.714285714286,25,4013000
2016,county,48029,Bexar,42003,Allegheny,PA,Pittsburgh,96,4901000,51052.083333333336,74,3445000,46554.05405405405,22,1456000
2016,county,48453,Travis,18003,Allen,IN,Rural Indiana,43,1133000,26348.837209302324,48,846000,17625.0,-5,287000
2016,county,48453,Travis,02020,Anchorage Borough,AK,Rural Alaska,71,3009000,42380.281690140844,70,2092000,29885.714285714286,1,917000
2016,county,48029,Bexar,02020,Anchorage Borough,AK,Rural Alaska,246,6284000,25544.71544715447,171,5068000,29637.426900584796,75,1216000
2016,county,48453,Travis,48005,Angelina,TX,Rural Texas,58,1505000,25948.275862068964,48,704000,14666.666666666666,10,801000
2016,county,48029,Bexar,48005,Angelina,TX,Rural Texas,55,1326000,24109.090909090908,50,1005000,20100.0,5,321000
2016,county,48453,Travis,24003,Anne Arundel,MD,Baltimore,66,2549000,38621.21212121212,114,5048000,44280.70175438596,-48,-2499000
2016,county,48029,Bexar,24003,Anne Arundel,MD,Baltimore,299,9570000,32006.6889632107,213,6250000,29342.723004694835,86,3320000
2016,county,48453,Travis,48007,Aransas,TX,Rural Texas,46,1053000,22891.304347826088,56,1985000,35446.42857142857,-10,-932000
2016,county,48029,Bexar,48007,Aransas,TX,Rural Texas,84,3106000,36976.19047619047,137,4964000,36233.57664233576,-53,-1858000
2016,county,48491,Williamson,08005,Arapahoe,CO,Denver,78,2896000,37128.205128205125,36,1352000,37555.555555555555,42,1544000
2016,county,48453,Travis,08005,Arapahoe,CO,Denver,139,5531000,39791.36690647482,214,7887000,36855.14018691589,-75,-2356000
2016,county,48029,Bexar,08005,Arapahoe,CO,Denver,159,4330000,27232.704402515723,177,6253000,35327.68361581921,-18,-1923000
2016,county,48453,Travis,51013,Arlington,VA,D.C.,147,10145000,69013.60544217686,103,7063000,68572.81553398058,44,3082000
2016,county,48029,Bexar,51013,Arlington,VA,D.C.,71,3778000,53211.2676056338,61,3772000,61836.065573770495,10,6000
2016,county,48029,Bexar,48013,Atascosa,TX,Rural Texas,1331,25131000,18881.29226145755,1516,24058000,15869.393139841688,-185,1073000
2016,county,48453,Travis,24005,Baltimore,MD,Baltimore,100,5979000,59790.0,183,4050000,22131.147540983606,-83,1929000
2016,county,48453,Travis,24510,Baltimore city,MD,Baltimore,104,2642000,25403.846153846152,349,4966000,14229.226361031519,-245,-2324000
2016,county,48029,Bexar,48019,Bandera,TX,Rural Texas,288,7393000,25670.13888888889,543,16683000,30723.75690607735,-255,-9290000
2016,county,48491,Williamson,48021,Bastrop,TX,Austin,364,8097000,22244.505494505494,566,15342000,27106.00706713781,-202,-7245000
2016,county,48453,Travis,48021,Bastrop,TX,Austin,1578,32221000,20418.884664131812,3080,58880000,19116.883116883117,-1502,-26659000
2016,county,48209,Hays,48021,Bastrop,TX,Austin,189,4364000,23089.94708994709,228,5550000,24342.105263157893,-39,-1186000
2016,county,48029,Bexar,48021,Bastrop,TX,Austin,83,2154000,25951.807228915663,132,2444000,18515.151515151516,-49,-290000
2016,county,48453,Travis,12005,Bay,FL,FL Panhandle,41,881000,21487.80487804878,69,1622000,23507.246376811596,-28,-741000
2016,county,48029,Bexar,12005,Bay,FL,FL Panhandle,72,1788000,24833.333333333332,76,1584000,20842.105263157893,-4,204000
2016,county,48029,Bexar,48025,Bee,TX,Rural Texas,127,2293000,18055.11811023622,96,1929000,20093.75,31,364000
2016,county,48491,Williamson,48027,Bell,TX,Rural Texas,1214,34273000,28231.46622734761,1392,31324000,22502.873563218393,-178,2949000
2016,county,48453,Travis,48027,Bell,TX,Rural Texas,922,22829000,24760.303687635576,1391,23480000,16879.942487419125,-469,-651000
2016,county,48209,Hays,48027,Bell,TX,Rural Texas,124,2276000,18354.83870967742,119,2848000,23932.7731092437,5,-572000
2016,county,48091,Comal,48027,Bell,TX,Rural Texas,77,1761000,22870.12987012987,41,1676000,40878.04878048781,36,85000
2016,county,48029,Bexar,48027,Bell,TX,Rural Texas,1097,23260000,21203.281677301733,743,14509000,19527.590847913863,354,8751000
2016,county,48453,Travis,05007,Benton,AR,Rural Arkansas,70,3275000,46785.71428571428,84,2040000,24285.714285714286,-14,1235000
2016,county,48029,Bexar,05007,Benton,AR,Rural Arkansas,43,1837000,42720.93023255814,50,1833000,36660.0,-7,4000
2016,county,48453,Travis,34003,Bergen,NJ,New York,84,3908000,46523.80952380953,193,20927000,108430.05181347151,-109,-17019000
2016,county,48491,Williamson,35001,Bernalillo,NM,Albuquerque,82,2374000,28951.219512195123,51,1672000,32784.313725490196,31,702000
2016,county,48453,Travis,35001,Bernalillo,NM,Albuquerque,224,9880000,44107.142857142855,233,6723000,28854.077253218886,-9,3157000
2016,county,48029,Bexar,35001,Bernalillo,NM,Albuquerque,221,7273000,32909.50226244344,173,4460000,25780.34682080925,48,2813000
2016,county,48491,Williamson,48029,Bexar,TX,San Antonio,982,29775000,30320.773930753563,761,24181000,31775.295663600526,221,5594000
2016,county,48453,Travis,48029,Bexar,TX,San Antonio,2556,95539000,37378.3255086072,2497,71677000,28705.246295554665,59,23862000
2016,county,48209,Hays,48029,Bexar,TX,San Antonio,671,23149000,34499.25484351714,658,14699000,22338.90577507599,13,8450000
2016,county,48091,Comal,48029,Bexar,TX,San Antonio,3461,132208000,38199.36434556486,1869,59429000,31797.2177635099,1592,72779000
2016,county,48453,Travis,48031,Blanco,TX,Rural Texas,45,1043000,23177.777777777777,100,5386000,53860.0,-55,-4343000
2016,county,48209,Hays,48031,Blanco,TX,Rural Texas,56,2073000,37017.857142857145,113,3095000,27389.380530973453,-57,-1022000
2016,county,48091,Comal,48031,Blanco,TX,Rural Texas,73,1869000,25602.739726027397,90,2494000,27711.11111111111,-17,-625000
2016,county,48029,Bexar,48031,Blanco,TX,Rural Texas,56,2013000,35946.42857142857,76,3561000,46855.26315789474,-20,-1548000
2016,county,48453,Travis,29019,Boone,MO,Columbia,33,1339000,40575.757575757576,50,1555000,31100.0,-17,-216000
2016,county,48029,Bexar,22015,Bossier Parish,LA,Rural Louisiana,139,3294000,23697.841726618706,85,2818000,33152.94117647059,54,476000
2016,county,48453,Travis,08013,Boulder,CO,Denver,102,7050000,69117.64705882352,193,23668000,122632.12435233161,-91,-16618000
2016,county,48491,Williamson,48039,Brazoria,TX,Houston,98,2594000,26469.38775510204,96,2398000,24979.166666666668,2,196000
2016,county,48453,Travis,48039,Brazoria,TX,Houston,205,9682000,47229.26829268293,202,5070000,25099.0099009901,3,4612000
2016,county,48209,Hays,48039,Brazoria,TX,Houston,64,5559000,86859.375,46,1441000,31326.08695652174,18,4118000
2016,county,48029,Bexar,48039,Brazoria,TX,Houston,183,5891000,32191.256830601094,303,6943000,22914.191419141913,-120,-1052000
2016,county,48491,Williamson,48041,Brazos,TX,Rural Texas,217,6587000,30354.83870967742,148,6719000,45398.64864864865,69,-132000
2016,county,48453,Travis,48041,Brazos,TX,Rural Texas,421,13686000,32508.3135391924,331,9417000,28450.151057401814,90,4269000
2016,county,48209,Hays,48041,Brazos,TX,Rural Texas,109,3157000,28963.302752293577,55,1382000,25127.272727272728,54,1775000
2016,county,48091,Comal,48041,Brazos,TX,Rural Texas,57,1865000,32719.298245614034,68,1723000,25338.235294117647,-11,142000
2016,county,48029,Bexar,48041,Brazos,TX,Rural Texas,340,8815000,25926.470588235294,207,6525000,31521.739130434784,133,2290000
2016,county,48453,Travis,12009,Brevard,FL,Atlantic Coast,102,2586000,25352.941176470587,239,3072000,12853.556485355648,-137,-486000
2016,county,48029,Bexar,12009,Brevard,FL,Atlantic Coast,99,2152000,21737.37373737374,101,2807000,27792.079207920793,-2,-655000
2016,county,48453,Travis,36005,Bronx,NY,New York,185,2403000,12989.18918918919,632,5784000,9151.898734177215,-447,-3381000
2016,county,48453,Travis,12011,Broward,FL,Miami,552,14779000,26773.55072463768,2035,41322000,20305.651105651104,-1483,-26543000
2016,county,48029,Bexar,12011,Broward,FL,Miami,183,4495000,24562.841530054644,133,4294000,32285.714285714286,50,201000
2016,county,48453,Travis,48049,Brown,TX,Rural Texas,34,863000,25382.352941176472,60,1345000,22416.666666666668,-26,-482000
2016,county,48453,Travis,42017,Bucks,PA,Philadelphia,65,1660000,25538.46153846154,44,1874000,42590.90909090909,21,-214000
2016,county,48453,Travis,37021,Buncombe,NC,Asheville,51,1535000,30098.039215686276,113,3900000,34513.27433628318,-62,-2365000
2016,county,48029,Bexar,34005,Burlington,NJ,Philadelphia,120,2421000,20175.0,62,1130000,18225.8064516129,58,1291000
2016,county,48491,Williamson,48053,Burnet,TX,Rural Texas,324,9608000,29654.320987654322,612,20825000,34027.77777777778,-288,-11217000
2016,county,48453,Travis,48053,Burnet,TX,Rural Texas,386,16037000,41546.632124352334,583,22252000,38168.096054888505,-197,-6215000
2016,county,48209,Hays,48053,Burnet,TX,Rural Texas,48,1638000,34125.0,80,3413000,42662.5,-32,-1775000
2016,county,48029,Bexar,48053,Burnet,TX,Rural Texas,122,3072000,25180.32786885246,106,3801000,35858.49056603773,16,-729000
2016,county,48453,Travis,39017,Butler,OH,Cincinnati,40,831000,20775.0,55,1112000,20218.18181818182,-15,-281000
2016,county,48453,Travis,22017,Caddo Parish,LA,Rural Louisiana,67,1517000,22641.79104477612,83,401000,4831.325301204819,-16,1116000
2016,county,48029,Bexar,22017,Caddo Parish,LA,Rural Louisiana,116,3107000,26784.48275862069,67,1381000,20611.940298507463,49,1726000
2016,county,48453,Travis,22019,Calcasieu Parish,LA,Rural Louisiana,52,1049000,20173.076923076922,52,1024000,19692.30769230769,0,25000
2016,county,48029,Bexar,22019,Calcasieu Parish,LA,Rural Louisiana,41,966000,23560.975609756097,43,1214000,28232.558139534885,-2,-248000
2016,county,48491,Williamson,48055,Caldwell,TX,Rural Texas,91,2005000,22032.967032967033,127,2828000,22267.716535433072,-36,-823000
2016,county,48453,Travis,48055,Caldwell,TX,Rural Texas,426,7564000,17755.86854460094,976,15934000,16325.819672131147,-550,-8370000
2016,county,48209,Hays,48055,Caldwell,TX,Rural Texas,663,12438000,18760.18099547511,743,12522000,16853.297442799463,-80,-84000
2016,county,48029,Bexar,48055,Caldwell,TX,Rural Texas,80,1324000,16550.0,68,1555000,22867.647058823528,12,-231000
2016,county,48453,Travis,34007,Camden,NJ,Philadelphia,39,1214000,31128.20512820513,85,1534000,18047.058823529413,-46,-320000
2016,county,48491,Williamson,48061,Cameron,TX,Rural Texas,149,5431000,36449.6644295302,55,1398000,25418.18181818182,94,4033000
2016,county,48453,Travis,48061,Cameron,TX,Rural Texas,415,9282000,22366.265060240963,354,6707000,18946.32768361582,61,2575000
2016,county,48209,Hays,48061,Cameron,TX,Rural Texas,90,1748000,19422.222222222223,58,1619000,27913.793103448275,32,129000
2016,county,48029,Bexar,48061,Cameron,TX,Rural Texas,1044,23146000,22170.498084291186,467,9664000,20693.790149892935,577,13482000
2016,county,48453,Travis,17019,Champaign,IL,Rural Illinois,73,1312000,17972.602739726026,74,1472000,19891.891891891893,-1,-160000
2016,county,48453,Travis,45019,Charleston,SC,Charleston,83,3977000,47915.66265060241,59,2094000,35491.52542372881,24,1883000
2016,county,48453,Travis,13051,Chatham,GA,Savannah,76,1739000,22881.57894736842,259,2528000,9760.61776061776,-183,-789000
2016,county,48029,Bexar,13051,Chatham,GA,Savannah,80,1316000,16450.0,79,1563000,19784.810126582277,1,-247000
2016,county,48453,Travis,51550,Chesapeake city,VA,Hampton Roads,37,1077000,29108.108108108107,49,463000,9448.979591836734,-12,614000
2016,county,48029,Bexar,51550,Chesapeake city,VA,Hampton Roads,64,1678000,26218.75,61,1431000,23459.016393442624,3,247000
2016,county,48453,Travis,42029,Chester,PA,Philadelphia,65,2941000,45246.153846153844,44,2654000,60318.181818181816,21,287000
2016,county,48029,Bexar,21047,Christian,KY,Rural Kentucky,51,722000,14156.862745098038,82,1105000,13475.609756097561,-31,-383000
2016,county,48453,Travis,41005,Clackamas,OR,Portland,41,1332000,32487.80487804878,97,4020000,41443.298969072166,-56,-2688000
2016,county,48491,Williamson,32003,Clark,NV,Las Vegas,173,6133000,35450.867052023124,146,4985000,34143.83561643836,27,1148000
2016,county,48453,Travis,32003,Clark,NV,Las Vegas,465,23342000,50197.84946236559,675,14595000,21622.222222222223,-210,8747000
2016,county,48453,Travis,53011,Clark,WA,Portland,46,2738000,59521.739130434784,87,3206000,36850.574712643676,-41,-468000
2016,county,48029,Bexar,32003,Clark,NV,Las Vegas,568,21073000,37100.35211267605,547,14023000,25636.19744058501,21,7050000
2016,county,48453,Travis,13059,Clarke,GA,Athens,37,1016000,27459.45945945946,55,764000,13890.90909090909,-18,252000
2016,county,48453,Travis,12019,Clay,FL,Jacksonville,49,1267000,25857.14285714286,82,2140000,26097.560975609755,-33,-873000
2016,county,48453,Travis,13063,Clayton,GA,Atlanta,90,848000,9422.222222222223,410,3496000,8526.829268292682,-320,-2648000
2016,county,48453,Travis,40027,Cleveland,OK,Oklahoma City,50,1383000,27660.0,50,2904000,58080.0,0,-1521000
2016,county,48029,Bexar,40027,Cleveland,OK,Oklahoma City,70,2497000,35671.42857142857,74,1630000,22027.027027027027,-4,867000
2016,county,48453,Travis,13067,Cobb,GA,Atlanta,217,7738000,35658.986175115206,367,7198000,19613.079019073568,-150,540000
2016,county,48029,Bexar,13067,Cobb,GA,Atlanta,111,3259000,29360.36036036036,85,2912000,34258.82352941176,26,347000
2016,county,48029,Bexar,04003,Cochise,AZ,Rural Arizona,109,1886000,17302.75229357798,82,2023000,24670.731707317074,27,-137000
2016,county,48453,Travis,12021,Collier,FL,S.W. Florida,91,3601000,39571.42857142857,218,7270000,33348.62385321101,-127,-3669000
2016,county,48491,Williamson,48085,Collin,TX,Dallas-Fort Worth,417,19995000,47949.640287769784,371,15315000,41280.32345013477,46,4680000
2016,county,48453,Travis,48085,Collin,TX,Dallas-Fort Worth,725,37588000,51845.51724137931,870,36438000,41882.75862068965,-145,1150000
2016,county,48209,Hays,48085,Collin,TX,Dallas-Fort Worth,117,5229000,44692.307692307695,90,2218000,24644.444444444445,27,3011000
2016,county,48029,Bexar,48085,Collin,TX,Dallas-Fort Worth,459,17333000,37762.52723311547,658,27360000,41580.54711246201,-199,-10027000
2016,county,48029,Bexar,13073,Columbia,GA,Augusta,95,2055000,21631.57894736842,117,3788000,32376.068376068375,-22,-1733000
2016,county,48491,Williamson,48091,Comal,TX,San Antonio,150,4456000,29706.666666666668,169,6262000,37053.25443786982,-19,-1806000
2016,county,48453,Travis,48091,Comal,TX,San Antonio,318,13146000,41339.622641509435,473,16963000,35862.579281183935,-155,-3817000
2016,county,48209,Hays,48091,Comal,TX,San Antonio,509,13684000,26884.08644400786,754,25430000,33726.79045092838,-245,-11746000
2016,county,48029,Bexar,48091,Comal,TX,San Antonio,1869,59429000,31797.2177635099,3461,132208000,38199.36434556486,-1592,-72779000
2016,county,48029,Bexar,40031,Comanche,OK,Rural Oklahoma,197,4202000,21329.94923857868,87,1649000,18954.02298850575,110,2553000
2016,county,48453,Travis,06013,Contra Costa,CA,Bay Area,211,23645000,112061.61137440758,275,17028000,61920.0,-64,6617000
2016,county,48029,Bexar,06013,Contra Costa,CA,Bay Area,80,3086000,38575.0,69,2998000,43449.27536231884,11,88000
2016,county,48491,Williamson,17031,Cook,IL,Chicago,288,10516000,36513.88888888889,91,2945000,32362.637362637364,197,7571000
2016,county,48453,Travis,17031,Cook,IL,Chicago,1394,68825000,49372.309899569584,1885,70115000,37196.28647214854,-491,-1290000
2016,county,48029,Bexar,17031,Cook,IL,Chicago,638,19197000,30089.341692789967,327,17629000,53911.31498470948,311,1568000
2016,county,48491,Williamson,48099,Coryell,TX,Rural Texas,174,3227000,18545.97701149425,145,3108000,21434.48275862069,29,119000
2016,county,48453,Travis,48099,Coryell,TX,Rural Texas,94,2030000,21595.744680851065,119,2298000,19310.9243697479,-25,-268000
2016,county,48029,Bexar,48099,Coryell,TX,Rural Texas,258,4299000,16662.79069767442,153,2123000,13875.816993464052,105,2176000
2016,county,48453,Travis,13077,Coweta,GA,Atlanta,142,1419000,9992.957746478873,94,1012000,10765.95744680851,48,407000
2016,county,48029,Bexar,37049,Craven,NC,Rural North Carolina,44,814000,18500.0,45,851000,18911.11111111111,-1,-37000
2016,county,48453,Travis,37051,Cumberland,NC,Rural North Carolina,69,1239000,17956.521739130436,108,1294000,11981.481481481482,-39,-55000
2016,county,48029,Bexar,37051,Cumberland,NC,Rural North Carolina,406,7892000,19438.423645320196,203,4464000,21990.147783251232,203,3428000
2016,county,48029,Bexar,35009,Curry,NM,Rural New Mexico,74,1819000,24581.08108108108,43,1076000,25023.25581395349,31,743000
2016,county,48453,Travis,39035,Cuyahoga,OH,Cleveland,161,4502000,27962.732919254657,489,6992000,14298.568507157464,-328,-2490000
2016,county,48029,Bexar,39035,Cuyahoga,OH,Cleveland,117,4247000,36299.1452991453,56,2230000,39821.42857142857,61,2017000
2016,county,48453,Travis,27037,Dakota,MN,Minneapolis,54,3507000,64944.444444444445,52,1516000,29153.846153846152,2,1991000
2016,county,48491,Williamson,48113,Dallas,TX,Dallas-Fort Worth,533,20355000,38189.49343339587,375,14073000,37528.0,158,6282000
2016,county,48453,Travis,48113,Dallas,TX,Dallas-Fort Worth,2176,108507000,49865.34926470588,2736,113772000,41583.333333333336,-560,-5265000
2016,county,48209,Hays,48113,Dallas,TX,Dallas-Fort Worth,186,5103000,27435.483870967742,128,3377000,26382.8125,58,1726000
2016,county,48091,Comal,48113,Dallas,TX,Dallas-Fort Worth,102,4040000,39607.8431372549,52,1864000,35846.153846153844,50,2176000
2016,county,48029,Bexar,48113,Dallas,TX,Dallas-Fort Worth,1215,41206000,33914.40329218107,1528,52756000,34526.1780104712,-313,-11550000
2016,county,48453,Travis,55025,Dane,WI,Madison,126,5851000,46436.50793650794,96,3548000,36958.333333333336,30,2303000
2016,county,48029,Bexar,55025,Dane,WI,Madison,64,2175000,33984.375,39,1125000,28846.153846153848,25,1050000
2016,county,48453,Travis,47037,Davidson,TN,Nashville,203,5703000,28093.5960591133,354,20334000,57440.67796610169,-151,-14631000
2016,county,48029,Bexar,47037,Davidson,TN,Nashville,98,4222000,43081.63265306123,89,3453000,38797.752808988764,9,769000
2016,county,48029,Bexar,49011,Davis,UT,Rural Utah,90,2250000,25000.0,91,1806000,19846.153846153848,-1,444000
2016,county,48453,Travis,13089,DeKalb,GA,Atlanta,259,6535000,25231.660231660233,821,10261000,12498.172959805115,-562,-3726000
2016,county,48029,Bexar,13089,DeKalb,GA,Atlanta,97,2451000,25268.0412371134,95,2898000,30505.263157894737,2,-447000
2016,county,48029,Bexar,48123,DeWitt,TX,Rural Texas,46,1040000,22608.695652173912,48,690000,14375.0,-2,350000
2016,county,48453,Travis,42045,Delaware,PA,Philadelphia,52,1591000,30596.153846153848,72,1043000,14486.111111111111,-20,548000
2016,county,48491,Williamson,48121,Denton,TX,Dallas-Fort Worth,354,12959000,36607.34463276836,344,12145000,35305.232558139534,10,814000
2016,county,48453,Travis,48121,Denton,TX,Dallas-Fort Worth,694,28785000,41476.94524495677,608,24864000,40894.73684210526,86,3921000
2016,county,48209,Hays,48121,Denton,TX,Dallas-Fort Worth,137,6756000,49313.868613138686,65,2471000,38015.38461538462,72,4285000
2016,county,48091,Comal,48121,Denton,TX,Dallas-Fort Worth,94,4648000,49446.8085106383,76,2523000,33197.36842105263,18,2125000
2016,county,48029,Bexar,48121,Denton,TX,Dallas-Fort Worth,450,13926000,30946.666666666668,566,25392000,44862.19081272085,-116,-11466000
2016,county,48491,Williamson,08031,Denver,CO,Denver,45,1804000,40088.88888888889,51,2179000,42725.490196078434,-6,-375000
2016,county,48453,Travis,08031,Denver,CO,Denver,297,18165000,61161.61616161616,458,18748000,40934.49781659389,-161,-583000
2016,county,48029,Bexar,08031,Denver,CO,Denver,109,3999000,36688.07339449541,135,5965000,44185.18518518518,-26,-1966000
2016,county,48029,Bexar,48127,Dimmit,TX,Rural Texas,114,1899000,16657.894736842107,70,1024000,14628.57142857143,44,875000
2016,county,48453,Travis,11001,District of Columbia,DC,D.C.,280,18293000,65332.142857142855,368,14844000,40336.95652173913,-88,3449000
2016,county,48029,Bexar,11001,District of Columbia,DC,D.C.,83,3628000,43710.843373493975,105,4291000,40866.666666666664,-22,-663000
2016,county,48453,Travis,35013,Dona Ana,NM,Rural New Mexico,52,2180000,41923.07692307692,53,565000,10660.377358490567,-1,1615000
2016,county,48029,Bexar,35013,Dona Ana,NM,Rural New Mexico,109,2141000,19642.201834862386,84,1558000,18547.619047619046,25,583000
2016,county,48491,Williamson,08035,Douglas,CO,Denver,73,3505000,48013.69863013698,71,2325000,32746.478873239437,2,1180000
2016,county,48453,Travis,31055,Douglas,NE,Omaha,93,3952000,42494.62365591398,94,2289000,24351.063829787236,-1,1663000
2016,county,48453,Travis,08035,Douglas,CO,Denver,124,6452000,52032.25806451613,120,6694000,55783.333333333336,4,-242000
2016,county,48029,Bexar,31055,Douglas,NE,Omaha,116,3059000,26370.689655172413,75,2143000,28573.333333333332,41,916000
2016,county,48029,Bexar,08035,Douglas,CO,Denver,77,4329000,56220.77922077922,105,4278000,40742.857142857145,-28,51000
2016,county,48453,Travis,17043,DuPage,IL,Chicago,222,18381000,82797.2972972973,180,10566000,58700.0,42,7815000
2016,county,48029,Bexar,17043,DuPage,IL,Chicago,120,5100000,42500.0,62,2227000,35919.354838709674,58,2873000
2016,county,48453,Travis,37063,Durham,NC,Raleigh,165,4392000,26618.18181818182,143,3766000,26335.664335664336,22,626000
2016,county,48453,Travis,36027,Dutchess,NY,Rural New York,49,2167000,44224.489795918365,37,865000,23378.37837837838,12,1302000
2016,county,48453,Travis,12031,Duval,FL,Jacksonville,203,4880000,24039.408866995072,595,10565000,17756.302521008405,-392,-5685000
2016,county,48029,Bexar,12031,Duval,FL,Jacksonville,139,3291000,23676.258992805757,195,5018000,25733.333333333332,-56,-1727000
2016,county,48453,Travis,22033,East Baton Rouge Parish,LA,Rural Louisiana,224,5538000,24723.214285714286,312,5876000,18833.333333333332,-88,-338000
2016,county,48029,Bexar,22033,East Baton Rouge Parish,LA,Rural Louisiana,79,2181000,27607.59493670886,51,1807000,35431.37254901961,28,374000
2016,county,48453,Travis,48135,Ector,TX,Rural Texas,157,3428000,21834.394904458597,104,2160000,20769.23076923077,53,1268000
2016,county,48029,Bexar,48135,Ector,TX,Rural Texas,403,8732000,21667.493796526054,147,3730000,25374.149659863946,256,5002000
2016,county,48491,Williamson,48141,El Paso,TX,El Paso,282,7109000,25209.21985815603,145,2940000,20275.862068965518,137,4169000
2016,county,48491,Williamson,08041,El Paso,CO,Colorado Springs,123,3578000,29089.43089430894,105,2642000,25161.904761904763,18,936000
2016,county,48453,Travis,48141,El Paso,TX,El Paso,581,17030000,29311.531841652322,411,9887000,24055.96107055961,170,7143000
2016,county,48453,Travis,08041,El Paso,CO,Colorado Springs,178,4948000,27797.752808988764,255,5783000,22678.43137254902,-77,-835000
2016,county,48209,Hays,48141,El Paso,TX,El Paso,72,1718000,23861.11111111111,50,968000,19360.0,22,750000
2016,county,48029,Bexar,48141,El Paso,TX,El Paso,1755,33845000,19284.900284900286,878,18040000,20546.697038724375,877,15805000
2016,county,48029,Bexar,08041,El Paso,CO,Colorado Springs,763,18578000,24348.623853211007,680,14647000,21539.70588235294,83,3931000
2016,county,48491,Williamson,48139,Ellis,TX,Dallas-Fort Worth,43,820000,19069.767441860466,56,1601000,28589.285714285714,-13,-781000
2016,county,48453,Travis,48139,Ellis,TX,Dallas-Fort Worth,72,1666000,23138.88888888889,87,2194000,25218.3908045977,-15,-528000
2016,county,48029,Bexar,48139,Ellis,TX,Dallas-Fort Worth,72,1572000,21833.333333333332,104,3246000,31211.53846153846,-32,-1674000
2016,county,48453,Travis,36029,Erie,NY,Buffalo,76,1821000,23960.526315789473,125,1896000,15168.0,-49,-75000
2016,county,48453,Travis,12033,Escambia,FL,FL Panhandle,66,1026000,15545.454545454546,176,2293000,13028.40909090909,-110,-1267000
2016,county,48029,Bexar,12033,Escambia,FL,FL Panhandle,131,3003000,22923.664122137405,121,2333000,19280.99173553719,10,670000
2016,county,48453,Travis,34013,Essex,NJ,New York,105,3511000,33438.09523809524,250,9770000,39080.0,-145,-6259000
2016,county,48453,Travis,25009,Essex,MA,Boston,50,1758000,35160.0,109,2721000,24963.302752293577,-59,-963000
2016,county,48029,Bexar,02090,Fairbanks North Star Borough,AK,Rural Alaska,108,2641000,24453.703703703704,81,2128000,26271.604938271605,27,513000
2016,county,48491,Williamson,51059,Fairfax,VA,D.C.,113,6012000,53203.53982300885,60,2368000,39466.666666666664,53,3644000
2016,county,48453,Travis,51059,Fairfax,VA,D.C.,326,17463000,53567.48466257669,281,24242000,86270.46263345196,45,-6779000
2016,county,48029,Bexar,51059,Fairfax,VA,D.C.,444,21625000,48704.954954954956,442,14482000,32764.70588235294,2,7143000
2016,county,48453,Travis,09001,Fairfield,CT,New York,156,13826000,88628.20512820513,225,24508000,108924.44444444444,-69,-10682000
2016,county,48453,Travis,48149,Fayette,TX,Rural Texas,65,1602000,24646.153846153848,99,2865000,28939.39393939394,-34,-1263000
2016,county,48453,Travis,21067,Fayette,KY,Lexington,67,2275000,33955.22388059701,65,2812000,43261.53846153846,2,-537000
2016,county,48453,Travis,37067,Forsyth,NC,Greensboro,60,1771000,29516.666666666668,103,1920000,18640.776699029127,-43,-149000
2016,county,48491,Williamson,48157,Fort Bend,TX,Houston,256,10573000,41300.78125,271,10019000,36970.47970479705,-15,554000
2016,county,48453,Travis,48157,Fort Bend,TX,Houston,621,36044000,58041.86795491143,699,29703000,42493.56223175966,-78,6341000
2016,county,48209,Hays,48157,Fort Bend,TX,Houston,121,5748000,47504.13223140496,75,2018000,26906.666666666668,46,3730000
2016,county,48091,Comal,48157,Fort Bend,TX,Houston,105,7345000,69952.38095238095,51,1370000,26862.745098039217,54,5975000
2016,county,48029,Bexar,48157,Fort Bend,TX,Houston,433,17210000,39745.9584295612,582,20062000,34470.790378006874,-149,-2852000
2016,county,48453,Travis,39049,Franklin,OH,Columbus,206,6690000,32475.728155339806,342,10347000,30254.385964912282,-136,-3657000
2016,county,48029,Bexar,39049,Franklin,OH,Columbus,141,4694000,33290.78014184397,202,5095000,25222.772277227723,-61,-401000
2016,county,48453,Travis,24021,Frederick,MD,Rural Maryland,37,2603000,70351.35135135135,39,2159000,55358.97435897436,-2,444000
2016,county,48029,Bexar,24021,Frederick,MD,Rural Maryland,77,1689000,21935.064935064936,54,1161000,21500.0,23,528000
2016,county,48453,Travis,06019,Fresno,CA,Fresno,103,1688000,16388.349514563106,168,2062000,12273.809523809523,-65,-374000
2016,county,48029,Bexar,06019,Fresno,CA,Fresno,84,3419000,40702.380952380954,43,1058000,24604.6511627907,41,2361000
2016,county,48029,Bexar,48163,Frio,TX,Rural Texas,175,4475000,25571.428571428572,199,3733000,18758.793969849245,-24,742000
2016,county,48491,Williamson,13121,Fulton,GA,Atlanta,44,1776000,40363.63636363636,67,2981000,44492.53731343283,-23,-1205000
2016,county,48453,Travis,13121,Fulton,GA,Atlanta,380,11572000,30452.63157894737,1121,27131000,24202.49776984835,-741,-15559000
2016,county,48029,Bexar,13121,Fulton,GA,Atlanta,111,2719000,24495.495495495496,142,5929000,41753.52112676056,-31,-3210000
2016,county,48491,Williamson,48167,Galveston,TX,Houston,91,3216000,35340.65934065934,121,2621000,21661.15702479339,-30,595000
2016,county,48453,Travis,48167,Galveston,TX,Houston,282,12919000,45812.05673758865,346,11328000,32739.884393063585,-64,1591000
2016,county,48209,Hays,48167,Galveston,TX,Houston,54,3429000,63500.0,53,1336000,25207.54716981132,1,2093000
2016,county,48029,Bexar,48167,Galveston,TX,Houston,179,6921000,38664.804469273746,217,6606000,30442.396313364054,-38,315000
2016,county,48029,Bexar,20061,Geary,KS,Rural Kansas,129,2319000,17976.74418604651,102,1295000,12696.078431372549,27,1024000
2016,county,48453,Travis,48171,Gillespie,TX,Rural Texas,58,1498000,25827.58620689655,132,6390000,48409.09090909091,-74,-4892000
2016,county,48029,Bexar,48171,Gillespie,TX,Rural Texas,110,3207000,29154.545454545456,104,3397000,32663.46153846154,6,-190000
2016,county,48029,Bexar,48177,Gonzales,TX,Rural Texas,82,1726000,21048.780487804877,62,909000,14661.290322580646,20,817000
2016,county,48453,Travis,48181,Grayson,TX,Rural Texas,33,1165000,35303.030303030304,53,957000,18056.603773584906,-20,208000
2016,county,48029,Bexar,39057,Greene,OH,Rural Ohio,105,4068000,38742.857142857145,120,3305000,27541.666666666668,-15,763000
2016,county,48453,Travis,45045,Greenville,SC,Greenville,91,1407000,15461.538461538461,94,2375000,25265.957446808512,-3,-968000
2016,county,48453,Travis,48183,Gregg,TX,Rural Texas,95,3452000,36336.84210526316,86,2575000,29941.86046511628,9,877000
2016,county,48491,Williamson,48187,Guadalupe,TX,San Antonio,96,3092000,32208.333333333332,96,2731000,28447.916666666668,0,361000
2016,county,48453,Travis,48187,Guadalupe,TX,San Antonio,206,6651000,32286.40776699029,308,10129000,32886.36363636364,-102,-3478000
2016,county,48209,Hays,48187,Guadalupe,TX,San Antonio,567,9970000,17583.774250440918,716,14158000,19773.743016759778,-149,-4188000
2016,county,48091,Comal,48187,Guadalupe,TX,San Antonio,2052,59392000,28943.46978557505,2166,55641000,25688.36565096953,-114,3751000
2016,county,48029,Bexar,48187,Guadalupe,TX,San Antonio,3099,78789000,25424.00774443369,4579,120060000,26219.698624153745,-1480,-41271000
2016,county,48453,Travis,37081,Guilford,NC,Greensboro,108,2825000,26157.40740740741,177,3006000,16983.050847457627,-69,-181000
2016,county,48029,Bexar,37081,Guilford,NC,Greensboro,53,2143000,40433.96226415094,39,996000,25538.46153846154,14,1147000
2016,county,48453,Travis,13135,Gwinnett,GA,Atlanta,186,4203000,22596.774193548386,397,5532000,13934.508816120906,-211,-1329000
2016,county,48029,Bexar,13135,Gwinnett,GA,Atlanta,101,2681000,26544.554455445545,101,2222000,22000.0,0,459000
2016,county,48453,Travis,39061,Hamilton,OH,Cincinnati,125,4106000,32848.0,228,3644000,15982.456140350878,-103,462000
2016,county,48453,Travis,18057,Hamilton,IN,Indianapolis,39,2178000,55846.153846153844,41,1720000,41951.21951219512,-2,458000
2016,county,48029,Bexar,39061,Hamilton,OH,Cincinnati,47,1535000,32659.574468085106,40,1590000,39750.0,7,-55000
2016,county,48029,Bexar,51650,Hampton city,VA,Hampton Roads,84,1893000,22535.714285714286,51,1321000,25901.960784313724,33,572000
2016,county,48029,Bexar,37085,Harnett,NC,Rural North Carolina,114,2348000,20596.491228070176,101,2001000,19811.881188118812,13,347000
2016,county,48491,Williamson,48201,Harris,TX,Houston,1337,52873000,39545.99850411369,912,29599000,32455.043859649122,425,23274000
2016,county,48453,Travis,48201,Harris,TX,Houston,3972,209751000,52807.40181268882,4424,154343000,34887.6582278481,-452,55408000
2016,county,48209,Hays,48201,Harris,TX,Houston,599,30531000,50969.94991652755,401,10651000,26561.097256857855,198,19880000
2016,county,48091,Comal,48201,Harris,TX,Houston,496,34068000,68685.48387096774,213,7808000,36657.27699530516,283,26260000
2016,county,48029,Bexar,48201,Harris,TX,Houston,3139,105334000,33556.54667091431,3167,98330000,31048.310704136406,-28,7004000
2016,county,48453,Travis,28047,Harrison,MS,Gulfport-Biloxi,58,919000,15844.827586206897,104,1011000,9721.153846153846,-46,-92000
2016,county,48029,Bexar,28047,Harrison,MS,Gulfport-Biloxi,275,5003000,18192.727272727272,107,2691000,25149.532710280375,168,2312000
2016,county,48453,Travis,09003,Hartford,CT,Hartford,101,5519000,54643.56435643564,235,5400000,22978.72340425532,-134,119000
2016,county,48029,Bexar,09003,Hartford,CT,Hartford,48,1430000,29791.666666666668,54,1906000,35296.2962962963,-6,-476000
2016,county,48491,Williamson,48209,Hays,TX,Austin,595,20569000,34569.747899159665,644,18467000,28675.465838509317,-49,2102000
2016,county,48453,Travis,48209,Hays,TX,Austin,3479,139397000,40068.12302385743,7403,235088000,31755.774685938133,-3924,-95691000
2016,county,48091,Comal,48209,Hays,TX,Austin,754,25430000,33726.79045092838,509,13684000,26884.08644400786,245,11746000
2016,county,48029,Bexar,48209,Hays,TX,Austin,658,14699000,22338.90577507599,671,23149000,34499.25484351714,-13,-8450000
2016,county,48453,Travis,48213,Henderson,TX,Rural Texas,28,857000,30607.14285714286,43,980000,22790.697674418603,-15,-123000
2016,county,48453,Travis,27053,Hennepin,MN,Minneapolis,252,23115000,91726.19047619047,267,9900000,37078.651685393255,-15,13215000
2016,county,48029,Bexar,27053,Hennepin,MN,Minneapolis,97,3802000,39195.87628865979,86,3446000,40069.767441860466,11,356000
2016,county,48453,Travis,51087,Henrico,VA,Richmond,48,1966000,40958.333333333336,86,3680000,42790.6976744186,-38,-1714000
2016,county,48491,Williamson,48215,Hidalgo,TX,Rural Texas,188,4968000,26425.531914893618,93,1476000,15870.967741935483,95,3492000
2016,county,48453,Travis,48215,Hidalgo,TX,Rural Texas,606,13188000,21762.37623762376,628,9128000,14535.031847133758,-22,4060000
2016,county,48209,Hays,48215,Hidalgo,TX,Rural Texas,149,4134000,27744.96644295302,66,1121000,16984.848484848484,83,3013000
2016,county,48029,Bexar,48215,Hidalgo,TX,Rural Texas,1675,35321000,21087.16417910448,879,24855000,28276.450511945393,796,10466000
2016,county,48453,Travis,12057,Hillsborough,FL,Tampa,440,9959000,22634.090909090908,1549,29003000,18723.69270497095,-1109,-19044000
2016,county,48453,Travis,33011,Hillsborough,NH,Rural New Hampshire,48,5653000,117770.83333333333,74,2876000,38864.86486486487,-26,2777000
2016,county,48029,Bexar,12057,Hillsborough,FL,Tampa,312,8452000,27089.74358974359,250,8429000,33716.0,62,23000
2016,county,48453,Travis,28049,Hinds,MS,Jackson,79,1288000,16303.79746835443,297,2736000,9212.121212121212,-218,-1448000
2016,county,48453,Travis,15003,Honolulu,HI,Rural Hawaii,151,4247000,28125.827814569537,175,8308000,47474.28571428572,-24,-4061000
2016,county,48029,Bexar,15003,Honolulu,HI,Rural Hawaii,874,19874000,22739.130434782608,566,12943000,22867.49116607774,308,6931000
2016,county,48453,Travis,48221,Hood,TX,Rural Texas,32,735000,22968.75,34,2575000,75735.29411764706,-2,-1840000
2016,county,48029,Bexar,13153,Houston,GA,Rural Georgia,108,2773000,25675.925925925927,53,1254000,23660.377358490565,55,1519000
2016,county,48453,Travis,24027,Howard,MD,Baltimore,42,1732000,41238.09523809524,66,2514000,38090.90909090909,-24,-782000
2016,county,48029,Bexar,24027,Howard,MD,Baltimore,111,5064000,45621.62162162162,76,2897000,38118.42105263158,35,2167000
2016,county,48453,Travis,34017,Hudson,NJ,New York,175,9191000,52520.0,159,4617000,29037.735849056604,16,4574000
2016,county,48029,Bexar,34017,Hudson,NJ,New York,60,1827000,30450.0,48,1526000,31791.666666666668,12,301000
2016,county,48453,Travis,29095,Jackson,MO,Kansas City,118,3027000,25652.542372881355,246,5464000,22211.38211382114,-128,-2437000
2016,county,48029,Bexar,29095,Jackson,MO,Kansas City,69,2172000,31478.260869565216,63,1350000,21428.571428571428,6,822000
2016,county,48491,Williamson,48245,Jefferson,TX,Rural Texas,84,2202000,26214.285714285714,39,864000,22153.846153846152,45,1338000
2016,county,48491,Williamson,08059,Jefferson,CO,Denver,52,2381000,45788.46153846154,41,1358000,33121.95121951219,11,1023000
2016,county,48453,Travis,48245,Jefferson,TX,Rural Texas,225,5696000,25315.555555555555,214,4154000,19411.21495327103,11,1542000
2016,county,48453,Travis,21111,Jefferson,KY,Louisville,122,3932000,32229.508196721312,156,4653000,29826.923076923078,-34,-721000
2016,county,48453,Travis,08059,Jefferson,CO,Denver,99,4626000,46727.27272727273,208,9105000,43774.03846153846,-109,-4479000
2016,county,48453,Travis,01073,Jefferson,AL,Birmingham,104,3923000,37721.153846153844,317,5019000,15832.807570977919,-213,-1096000
2016,county,48029,Bexar,36045,Jefferson,NY,Rural New York,176,2812000,15977.272727272728,113,2033000,17991.150442477876,63,779000
2016,county,48029,Bexar,48245,Jefferson,TX,Rural Texas,110,4269000,38809.09090909091,90,2609000,28988.88888888889,20,1660000
2016,county,48029,Bexar,08059,Jefferson,CO,Denver,61,2292000,37573.770491803276,97,3288000,33896.907216494845,-36,-996000
2016,county,48029,Bexar,21111,Jefferson,KY,Louisville,63,1857000,29476.190476190477,81,3334000,41160.49382716049,-18,-1477000
2016,county,48029,Bexar,01073,Jefferson,AL,Birmingham,52,1461000,28096.153846153848,53,1566000,29547.169811320753,-1,-105000
2016,county,48453,Travis,22051,Jefferson Parish,LA,New Orleans,108,2163000,20027.777777777777,177,3373000,19056.49717514124,-69,-1210000
2016,county,48029,Bexar,22051,Jefferson Parish,LA,New Orleans,90,2479000,27544.444444444445,53,1297000,24471.69811320755,37,1182000
2016,county,48029,Bexar,48249,Jim Wells,TX,Rural Texas,255,5862000,22988.235294117647,96,1471000,15322.916666666666,159,4391000
2016,county,48453,Travis,20091,Johnson,KS,Kansas City,129,5994000,46465.11627906977,149,4710000,31610.738255033557,-20,1284000
2016,county,48453,Travis,48251,Johnson,TX,Dallas-Fort Worth,41,1162000,28341.463414634145,75,1078000,14373.333333333334,-34,84000
2016,county,48029,Bexar,20091,Johnson,KS,Kansas City,67,4727000,70552.23880597015,90,2838000,31533.333333333332,-23,1889000
2016,county,48029,Bexar,48251,Johnson,TX,Dallas-Fort Worth,51,926000,18156.86274509804,106,2085000,19669.811320754718,-55,-1159000
2016,county,48453,Travis,26077,Kalamazoo,MI,Rural Michigan,35,535000,15285.714285714286,50,702000,14040.0,-15,-167000
2016,county,48453,Travis,17089,Kane,IL,Chicago,82,4203000,51256.09756097561,72,2595000,36041.666666666664,10,1608000
2016,county,48029,Bexar,48255,Karnes,TX,Rural Texas,123,4563000,37097.560975609755,105,2794000,26609.52380952381,18,1769000
2016,county,48453,Travis,48257,Kaufman,TX,Dallas-Fort Worth,35,1015000,29000.0,36,635000,17638.88888888889,-1,380000
2016,county,48453,Travis,48259,Kendall,TX,Rural Texas,77,2925000,37987.01298701299,69,3210000,46521.739130434784,8,-285000
2016,county,48091,Comal,48259,Kendall,TX,Rural Texas,156,7392000,47384.61538461538,102,4354000,42686.27450980392,54,3038000
2016,county,48029,Bexar,48259,Kendall,TX,Rural Texas,1045,46469000,44467.94258373206,1997,116479000,58326.990485728595,-952,-70010000
2016,county,48453,Travis,26081,Kent,MI,Rural Michigan,74,1655000,22364.864864864863,139,1797000,12928.057553956834,-65,-142000
2016,county,48029,Bexar,10001,Kent,DE,Rural Delaware,53,1063000,20056.603773584906,48,1084000,22583.333333333332,5,-21000
2016,county,48453,Travis,06029,Kern,CA,Rural California,142,3132000,22056.338028169015,192,1519000,7911.458333333333,-50,1613000
2016,county,48029,Bexar,06029,Kern,CA,Rural California,137,3052000,22277.372262773722,65,1455000,22384.615384615383,72,1597000
2016,county,48453,Travis,48265,Kerr,TX,Rural Texas,111,3397000,30603.603603603602,109,6995000,64174.31192660551,2,-3598000
2016,county,48029,Bexar,48265,Kerr,TX,Rural Texas,325,7211000,22187.69230769231,352,10014000,28448.863636363636,-27,-2803000
2016,county,48491,Williamson,53033,King,WA,Seattle,191,9550000,50000.0,153,7780000,50849.67320261438,38,1770000
2016,county,48453,Travis,53033,King,WA,Seattle,529,44438000,84003.78071833648,860,51510000,59895.348837209305,-331,-7072000
2016,county,48029,Bexar,53033,King,WA,Seattle,261,10238000,39226.053639846745,318,12007000,37757.86163522013,-57,-1769000
2016,county,48453,Travis,36047,Kings,NY,New York,578,28474000,49262.975778546715,796,29539000,37109.29648241206,-218,-1065000
2016,county,48029,Bexar,36047,Kings,NY,New York,121,2576000,21289.256198347106,95,2128000,22400.0,26,448000
2016,county,48029,Bexar,53035,Kitsap,WA,Rural Washington,55,1499000,27254.545454545456,104,1919000,18451.923076923078,-49,-420000
2016,county,48029,Bexar,48273,Kleberg,TX,Rural Texas,118,2210000,18728.813559322032,82,1573000,19182.926829268294,36,637000
2016,county,48453,Travis,47093,Knox,TN,Knoxville,43,2073000,48209.3023255814,98,3112000,31755.102040816328,-55,-1039000
2016,county,48029,Bexar,48283,La Salle,TX,Rural Texas,47,993000,21127.659574468085,48,742000,15458.333333333334,-1,251000
2016,county,48453,Travis,22055,Lafayette Parish,LA,Rural Louisiana,75,2478000,33040.0,71,1867000,26295.774647887323,4,611000
2016,county,48453,Travis,17097,Lake,IL,Chicago,187,11870000,63475.935828877,167,21784000,130443.1137724551,20,-9914000
2016,county,48453,Travis,18089,Lake,IN,Rural Indiana,46,934000,20304.347826086956,109,1122000,10293.577981651377,-63,-188000
2016,county,48453,Travis,12069,Lake,FL,Orlando,36,733000,20361.11111111111,144,2145000,14895.833333333334,-108,-1412000
2016,county,48029,Bexar,17097,Lake,IL,Chicago,131,4038000,30824.42748091603,61,1513000,24803.27868852459,70,2525000
2016,county,48491,Williamson,48281,Lampasas,TX,Rural Texas,63,1638000,26000.0,106,3590000,33867.92452830189,-43,-1952000
2016,county,48453,Travis,48281,Lampasas,TX,Rural Texas,40,750000,18750.0,84,1730000,20595.238095238095,-44,-980000
2016,county,48453,Travis,31109,Lancaster,NE,Rural Nebraska,41,804000,19609.756097560974,55,1509000,27436.363636363636,-14,-705000
2016,county,48453,Travis,42071,Lancaster,PA,Rural Pennsylvania,30,736000,24533.333333333332,69,1188000,17217.391304347828,-39,-452000
2016,county,48029,Bexar,31109,Lancaster,NE,Rural Nebraska,49,1112000,22693.877551020407,38,607000,15973.684210526315,11,505000
2016,county,48453,Travis,41039,Lane,OR,Rural Oregon,52,1179000,22673.076923076922,122,3143000,25762.29508196721,-70,-1964000
2016,county,48029,Bexar,56021,Laramie,WY,Rural Wyoming,55,1141000,20745.454545454544,52,1334000,25653.846153846152,3,-193000
2016,county,48453,Travis,08069,Larimer,CO,Rural Colorado,89,3459000,38865.168539325845,99,5036000,50868.68686868687,-10,-1577000
2016,county,48029,Bexar,20103,Leavenworth,KS,Kansas City,75,1648000,21973.333333333332,75,1773000,23640.0,0,-125000
2016,county,48491,Williamson,48287,Lee,TX,Rural Texas,56,1992000,35571.42857142857,69,1385000,20072.463768115944,-13,607000
2016,county,48453,Travis,12071,Lee,FL,S.W. Florida,163,3928000,24098.159509202455,494,8810000,17834.00809716599,-331,-4882000
2016,county,48453,Travis,48287,Lee,TX,Rural Texas,66,2151000,32590.909090909092,123,2521000,20495.934959349594,-57,-370000
2016,county,48029,Bexar,12071,Lee,FL,S.W. Florida,39,1385000,35512.820512820515,83,2607000,31409.63855421687,-44,-1222000
2016,county,48453,Travis,12073,Leon,FL,Rural Florida,94,2091000,22244.68085106383,202,2705000,13391.089108910892,-108,-614000
2016,county,48029,Bexar,48297,Live Oak,TX,Rural Texas,78,1630000,20897.4358974359,43,980000,22790.697674418603,35,650000
2016,county,48491,Williamson,48299,Llano,TX,Rural Texas,59,1638000,27762.71186440678,113,3753000,33212.38938053097,-54,-2115000
2016,county,48453,Travis,48299,Llano,TX,Rural Texas,82,3535000,43109.756097560974,137,11585000,84562.04379562044,-55,-8050000
2016,county,48491,Williamson,06037,Los Angeles,CA,Los Angeles,541,17942000,33164.510166358596,155,5082000,32787.096774193546,386,12860000
2016,county,48453,Travis,06037,Los Angeles,CA,Los Angeles,1812,72898000,40230.68432671082,2484,115921000,46667.0692431562,-672,-43023000
2016,county,48209,Hays,06037,Los Angeles,CA,Los Angeles,100,5003000,50030.0,40,1012000,25300.0,60,3991000
2016,county,48029,Bexar,06037,Los Angeles,CA,Los Angeles,1021,27992000,27416.258570029382,592,15148000,25587.837837837837,429,12844000
2016,county,48453,Travis,51107,Loudoun,VA,Rural Virginia,85,6073000,71447.05882352941,44,2461000,55931.818181818184,41,3612000
2016,county,48029,Bexar,51107,Loudoun,VA,Rural Virginia,88,3822000,43431.818181818184,70,2431000,34728.57142857143,18,1391000
2016,county,48491,Williamson,48303,Lubbock,TX,Rural Texas,177,5018000,28350.282485875705,124,3113000,25104.83870967742,53,1905000
2016,county,48453,Travis,48303,Lubbock,TX,Rural Texas,326,16758000,51404.907975460126,234,6542000,27957.264957264957,92,10216000
2016,county,48209,Hays,48303,Lubbock,TX,Rural Texas,62,1968000,31741.935483870966,51,1345000,26372.549019607843,11,623000
2016,county,48029,Bexar,48303,Lubbock,TX,Rural Texas,361,8467000,23454.293628808864,223,4799000,21520.179372197308,138,3668000
2016,county,48453,Travis,39095,Lucas,OH,Rural Ohio,53,727000,13716.981132075472,133,1327000,9977.443609022557,-80,-600000
2016,county,48453,Travis,26099,Macomb,MI,Rural Michigan,76,2090000,27500.0,208,3191000,15341.346153846154,-132,-1101000
2016,county,48453,Travis,01089,Madison,AL,Huntsville,66,1811000,27439.39393939394,145,3142000,21668.96551724138,-79,-1331000
2016,county,48029,Bexar,01089,Madison,AL,Huntsville,43,1838000,42744.186046511626,70,2101000,30014.285714285714,-27,-263000
2016,county,48453,Travis,12081,Manatee,FL,Rural Florida,73,1412000,19342.465753424658,182,3055000,16785.714285714286,-109,-1643000
2016,county,48491,Williamson,04013,Maricopa,AZ,Phoenix,301,12763000,42401.993355481725,324,10946000,33783.950617283954,-23,1817000
2016,county,48453,Travis,04013,Maricopa,AZ,Phoenix,1163,39361000,33844.36801375752,1524,56297000,36940.28871391076,-361,-16936000
2016,county,48209,Hays,04013,Maricopa,AZ,Phoenix,62,2051000,33080.645161290326,86,3356000,39023.25581395349,-24,-1305000
2016,county,48029,Bexar,04013,Maricopa,AZ,Phoenix,731,20476000,28010.9439124487,701,20190000,28801.711840228247,30,286000
2016,county,48453,Travis,06041,Marin,CA,Bay Area,65,3508000,53969.230769230766,62,2780000,44838.709677419356,3,728000
2016,county,48453,Travis,18097,Marion,IN,Indianapolis,184,4673000,25396.739130434784,272,4459000,16393.382352941175,-88,214000
2016,county,48453,Travis,12083,Marion,FL,Rural Florida,61,961000,15754.098360655738,218,1929000,8848.62385321101,-157,-968000
2016,county,48029,Bexar,18097,Marion,IN,Indianapolis,97,2076000,21402.061855670105,67,1880000,28059.701492537315,30,196000
2016,county,48453,Travis,15009,Maui,HI,Rural Hawaii,38,1245000,32763.157894736843,47,1561000,33212.765957446805,-9,-316000
2016,county,48029,Bexar,48323,Maverick,TX,Rural Texas,647,11365000,17565.687789799074,344,4691000,13636.627906976744,303,6674000
2016,county,48491,Williamson,48309,McLennan,TX,Rural Texas,264,6851000,25950.757575757576,190,4088000,21515.78947368421,74,2763000
2016,county,48453,Travis,48309,McLennan,TX,Rural Texas,335,9929000,29638.805970149253,403,10901000,27049.627791563275,-68,-972000
2016,county,48209,Hays,48309,McLennan,TX,Rural Texas,52,1220000,23461.53846153846,67,1961000,29268.65671641791,-15,-741000
2016,county,48029,Bexar,48309,McLennan,TX,Rural Texas,240,5416000,22566.666666666668,216,4728000,21888.88888888889,24,688000
2016,county,48453,Travis,37119,Mecklenburg,NC,Charlotte,220,8326000,37845.454545454544,368,11262000,30603.260869565216,-148,-2936000
2016,county,48029,Bexar,37119,Mecklenburg,NC,Charlotte,105,3285000,31285.714285714286,146,6168000,42246.57534246575,-41,-2883000
2016,county,48453,Travis,48325,Medina,TX,Rural Texas,37,1187000,32081.08108108108,40,916000,22900.0,-3,271000
2016,county,48029,Bexar,48325,Medina,TX,Rural Texas,1050,24353000,23193.333333333332,1537,40078000,26075.471698113208,-487,-15725000
2016,county,48453,Travis,34021,Mercer,NJ,Rural New Jersey,63,4213000,66873.01587301587,77,2468000,32051.948051948053,-14,1745000
2016,county,48453,Travis,12086,Miami-Dade,FL,Miami,1036,21399000,20655.405405405407,3645,68762000,18864.74622770919,-2609,-47363000
2016,county,48029,Bexar,12086,Miami-Dade,FL,Miami,284,6256000,22028.169014084506,161,3925000,24378.88198757764,123,2331000
2016,county,48453,Travis,25017,Middlesex,MA,Boston,336,16748000,49845.23809523809,298,13003000,43634.22818791946,38,3745000
2016,county,48453,Travis,34023,Middlesex,NJ,New York,127,4805000,37834.64566929134,129,2976000,23069.767441860466,-2,1829000
2016,county,48029,Bexar,25017,Middlesex,MA,Boston,122,4706000,38573.770491803276,103,5257000,51038.83495145631,19,-551000
2016,county,48491,Williamson,48329,Midland,TX,Rural Texas,141,5489000,38929.0780141844,40,796000,19900.0,101,4693000
2016,county,48453,Travis,48329,Midland,TX,Rural Texas,245,10654000,43485.71428571428,151,5715000,37847.682119205296,94,4939000
2016,county,48029,Bexar,48329,Midland,TX,Rural Texas,355,9692000,27301.408450704224,255,9286000,36415.686274509804,100,406000
2016,county,48491,Williamson,48331,Milam,TX,Rural Texas,143,2908000,20335.664335664336,250,5168000,20672.0,-107,-2260000
2016,county,48453,Travis,48331,Milam,TX,Rural Texas,67,1001000,14940.298507462687,139,3151000,22669.06474820144,-72,-2150000
2016,county,48453,Travis,55079,Milwaukee,WI,Milwaukee,278,5466000,19661.87050359712,447,10890000,24362.41610738255,-169,-5424000
2016,county,48029,Bexar,55079,Milwaukee,WI,Milwaukee,196,4427000,22586.73469387755,48,819000,17062.5,148,3608000
2016,county,48453,Travis,01097,Mobile,AL,Mobile,82,1340000,16341.463414634147,218,2021000,9270.642201834862,-136,-681000
2016,county,48453,Travis,34025,Monmouth,NJ,New York,31,1360000,43870.967741935485,77,3590000,46623.37662337662,-46,-2230000
2016,county,48453,Travis,36055,Monroe,NY,Rochester,67,2283000,34074.62686567164,134,2458000,18343.283582089553,-67,-175000
2016,county,48453,Travis,12087,Monroe,FL,S.W. Florida,24,961000,40041.666666666664,34,879000,25852.941176470587,-10,82000
2016,county,48453,Travis,06053,Monterey,CA,Rural California,64,1971000,30796.875,55,1477000,26854.545454545456,9,494000
2016,county,48029,Bexar,06053,Monterey,CA,Rural California,144,3602000,25013.88888888889,89,1759000,19764.044943820223,55,1843000
2016,county,48491,Williamson,48339,Montgomery,TX,Houston,259,10708000,41343.62934362934,223,8313000,37278.026905829596,36,2395000
2016,county,48491,Williamson,24031,Montgomery,MD,D.C.,60,3116000,51933.333333333336,45,2173000,48288.88888888889,15,943000
2016,county,48453,Travis,48339,Montgomery,TX,Houston,433,20939000,48357.96766743649,423,18679000,44158.39243498818,10,2260000
2016,county,48453,Travis,24031,Montgomery,MD,D.C.,210,9441000,44957.142857142855,199,9134000,45899.497487437184,11,307000
2016,county,48453,Travis,42091,Montgomery,PA,Philadelphia,71,2425000,34154.92957746479,99,5991000,60515.15151515151,-28,-3566000
2016,county,48453,Travis,39113,Montgomery,OH,Rural Ohio,56,1377000,24589.285714285714,159,2148000,13509.433962264151,-103,-771000
2016,county,48453,Travis,01101,Montgomery,AL,Montgomery,68,900000,13235.29411764706,292,2429000,8318.493150684932,-224,-1529000
2016,county,48209,Hays,48339,Montgomery,TX,Houston,134,6689000,49917.91044776119,81,1954000,24123.456790123455,53,4735000
2016,county,48091,Comal,48339,Montgomery,TX,Houston,111,7343000,66153.15315315315,84,2706000,32214.285714285714,27,4637000
2016,county,48029,Bexar,48339,Montgomery,TX,Houston,307,11300000,36807.817589576545,370,14063000,38008.10810810811,-63,-2763000
2016,county,48029,Bexar,24031,Montgomery,MD,D.C.,227,7553000,33273.12775330397,144,4983000,34604.166666666664,83,2570000
2016,county,48029,Bexar,47125,Montgomery,TN,Rural Tennessee,169,4295000,25414.201183431953,174,3840000,22068.96551724138,-5,455000
2016,county,48029,Bexar,01101,Montgomery,AL,Montgomery,134,3204000,23910.44776119403,94,2499000,26585.106382978724,40,705000
2016,county,48029,Bexar,39113,Montgomery,OH,Rural Ohio,129,3000000,23255.81395348837,122,3214000,26344.262295081968,7,-214000
2016,county,48453,Travis,34027,Morris,NJ,New York,64,7434000,116156.25,111,13465000,121306.3063063063,-47,-6031000
2016,county,48453,Travis,41051,Multnomah,OR,Portland,155,6062000,39109.67741935484,421,17170000,40783.84798099763,-266,-11108000
2016,county,48029,Bexar,41051,Multnomah,OR,Portland,51,1430000,28039.21568627451,83,3133000,37746.98795180723,-32,-1703000
2016,county,48453,Travis,13215,Muscogee,GA,Columbus,46,1120000,24347.82608695652,170,2371000,13947.058823529413,-124,-1251000
2016,county,48029,Bexar,13215,Muscogee,GA,Columbus,126,2531000,20087.301587301587,98,1972000,20122.448979591838,28,559000
2016,county,48453,Travis,48347,Nacogdoches,TX,Rural Texas,31,1260000,40645.16129032258,74,1740000,23513.513513513513,-43,-480000
2016,county,48453,Travis,36059,Nassau,NY,New York,106,3912000,36905.660377358494,221,59438000,268950.2262443439,-115,-55526000
2016,county,48453,Travis,10003,New Castle,DE,Rural Delaware,54,2535000,46944.444444444445,117,2354000,20119.65811965812,-63,181000
2016,county,48453,Travis,37129,New Hanover,NC,Rural North Carolina,45,1271000,28244.444444444445,51,1571000,30803.92156862745,-6,-300000
2016,county,48453,Travis,09009,New Haven,CT,New Haven,118,3667000,31076.271186440677,235,4803000,20438.297872340427,-117,-1136000
2016,county,48453,Travis,36061,New York,NY,New York,573,75752000,132202.4432809773,614,121261000,197493.48534201956,-41,-45509000
2016,county,48029,Bexar,36061,New York,NY,New York,104,5852000,56269.230769230766,73,3886000,53232.87671232877,31,1966000
2016,county,48029,Bexar,51700,Newport News city,VA,Hampton Roads,137,2774000,20248.17518248175,98,2413000,24622.448979591838,39,361000
2016,county,48453,Travis,25021,Norfolk,MA,Boston,102,5243000,51401.96078431373,112,8692000,77607.14285714286,-10,-3449000
2016,county,48453,Travis,51710,Norfolk city,VA,Hampton Roads,56,1809000,32303.571428571428,99,620000,6262.626262626262,-43,1189000
2016,county,48029,Bexar,51710,Norfolk city,VA,Hampton Roads,123,2123000,17260.162601626016,82,1615000,19695.121951219513,41,508000
2016,county,48491,Williamson,48355,Nueces,TX,Rural Texas,207,8422000,40685.99033816425,142,4553000,32063.38028169014,65,3869000
2016,county,48453,Travis,48355,Nueces,TX,Rural Texas,480,16905000,35218.75,351,9007000,25660.96866096866,129,7898000
2016,county,48209,Hays,48355,Nueces,TX,Rural Texas,127,3452000,27181.102362204725,73,1798000,24630.13698630137,54,1654000
2016,county,48091,Comal,48355,Nueces,TX,Rural Texas,161,5039000,31298.13664596273,62,2316000,37354.83870967742,99,2723000
2016,county,48029,Bexar,48355,Nueces,TX,Rural Texas,1738,54486000,31349.82738780207,1036,23387000,22574.324324324323,702,31099000
2016,county,48453,Travis,26125,Oakland,MI,Detroit,163,5911000,36263.8036809816,276,9491000,34387.68115942029,-113,-3580000
2016,county,48029,Bexar,26125,Oakland,MI,Detroit,118,4422000,37474.57627118644,73,6061000,83027.39726027397,45,-1639000
2016,county,48453,Travis,34029,Ocean,NJ,New York,48,1520000,31666.666666666668,63,1469000,23317.460317460318,-15,51000
2016,county,48453,Travis,12091,Okaloosa,FL,FL Panhandle,28,732000,26142.85714285714,78,1009000,12935.897435897436,-50,-277000
2016,county,48029,Bexar,12091,Okaloosa,FL,FL Panhandle,270,5854000,21681.48148148148,229,5716000,24960.69868995633,41,138000
2016,county,48491,Williamson,40109,Oklahoma,OK,Oklahoma City,65,3189000,49061.53846153846,53,2191000,41339.622641509435,12,998000
2016,county,48453,Travis,40109,Oklahoma,OK,Oklahoma City,212,6739000,31787.735849056604,220,8035000,36522.72727272727,-8,-1296000
2016,county,48029,Bexar,40109,Oklahoma,OK,Oklahoma City,240,10532000,43883.333333333336,229,7215000,31506.55021834061,11,3317000
2016,county,48453,Travis,36067,Onondaga,NY,Rural New York,42,1137000,27071.428571428572,72,1068000,14833.333333333334,-30,69000
2016,county,48453,Travis,37133,Onslow,NC,Rural North Carolina,54,1079000,19981.48148148148,65,973000,14969.23076923077,-11,106000
2016,county,48029,Bexar,37133,Onslow,NC,Rural North Carolina,212,3779000,17825.471698113208,131,2124000,16213.740458015267,81,1655000
2016,county,48491,Williamson,06059,Orange,CA,Los Angeles,329,14431000,43863.22188449848,112,3903000,34848.21428571428,217,10528000
2016,county,48491,Williamson,12095,Orange,FL,Orlando,57,1634000,28666.666666666668,60,1832000,30533.333333333332,-3,-198000
2016,county,48453,Travis,06059,Orange,CA,Los Angeles,591,28542000,48294.41624365482,533,21594000,40514.0712945591,58,6948000
2016,county,48453,Travis,12095,Orange,FL,Orlando,365,9005000,24671.23287671233,1304,21318000,16348.159509202455,-939,-12313000
2016,county,48453,Travis,48361,Orange,TX,Rural Texas,30,1145000,38166.666666666664,43,696000,16186.046511627907,-13,449000
2016,county,48453,Travis,36071,Orange,NY,Rural New York,39,1078000,27641.02564102564,72,1421000,19736.11111111111,-33,-343000
2016,county,48453,Travis,37135,Orange,NC,Raleigh,38,2267000,59657.89473684211,42,1357000,32309.52380952381,-4,910000
2016,county,48029,Bexar,06059,Orange,CA,Los Angeles,326,11396000,34957.05521472393,188,6811000,36228.72340425532,138,4585000
2016,county,48029,Bexar,12095,Orange,FL,Orlando,207,5012000,24212.56038647343,155,4353000,28083.870967741936,52,659000
2016,county,48029,Bexar,36071,Orange,NY,Rural New York,55,1701000,30927.272727272728,52,920000,17692.30769230769,3,781000
2016,county,48453,Travis,22071,Orleans Parish,LA,New Orleans,140,4548000,32485.714285714286,236,5428000,23000.0,-96,-880000
2016,county,48029,Bexar,22071,Orleans Parish,LA,New Orleans,75,1518000,20240.0,84,2448000,29142.85714285714,-9,-930000
2016,county,48453,Travis,12097,Osceola,FL,Orlando,72,1377000,19125.0,332,3938000,11861.44578313253,-260,-2561000
2016,county,48029,Bexar,12097,Osceola,FL,Orlando,53,1049000,19792.45283018868,40,613000,15325.0,13,436000
2016,county,48029,Bexar,35035,Otero,NM,Rural New Mexico,95,1872000,19705.263157894737,52,1849000,35557.692307692305,43,23000
2016,county,48491,Williamson,12099,Palm Beach,FL,Miami,49,2138000,43632.65306122449,54,2056000,38074.07407407407,-5,82000
2016,county,48453,Travis,12099,Palm Beach,FL,Miami,393,12988000,33048.346055979644,1442,41734000,28941.747572815533,-1049,-28746000
2016,county,48029,Bexar,12099,Palm Beach,FL,Miami,82,2513000,30646.341463414636,87,2919000,33551.724137931036,-5,-406000
2016,county,48453,Travis,48367,Parker,TX,Dallas-Fort Worth,69,2383000,34536.23188405797,78,3072000,39384.61538461538,-9,-689000
2016,county,48029,Bexar,48367,Parker,TX,Dallas-Fort Worth,40,1096000,27400.0,63,2348000,37269.84126984127,-23,-1252000
2016,county,48453,Travis,12101,Pasco,FL,Tampa,82,1457000,17768.29268292683,236,3981000,16868.64406779661,-154,-2524000
2016,county,48029,Bexar,12101,Pasco,FL,Tampa,50,1265000,25300.0,51,1856000,36392.1568627451,-1,-591000
2016,county,48453,Travis,34031,Passaic,NJ,New York,43,998000,23209.302325581397,118,1682000,14254.237288135593,-75,-684000
2016,county,48453,Travis,42101,Philadelphia,PA,Philadelphia,264,9888000,37454.545454545456,641,12400000,19344.773790951636,-377,-2512000
2016,county,48029,Bexar,42101,Philadelphia,PA,Philadelphia,73,1665000,22808.219178082192,46,1215000,26413.043478260868,27,450000
2016,county,48491,Williamson,53053,Pierce,WA,Seattle,56,1437000,25660.714285714286,45,815000,18111.11111111111,11,622000
2016,county,48453,Travis,53053,Pierce,WA,Seattle,105,2720000,25904.761904761905,216,5335000,24699.074074074073,-111,-2615000
2016,county,48029,Bexar,53053,Pierce,WA,Seattle,462,10537000,22807.359307359307,319,7294000,22865.203761755485,143,3243000
2016,county,48491,Williamson,04019,Pima,AZ,Tucson,73,2170000,29726.027397260274,58,1712000,29517.241379310344,15,458000
2016,county,48453,Travis,04019,Pima,AZ,Tucson,196,5850000,29846.938775510203,245,6280000,25632.65306122449,-49,-430000
2016,county,48029,Bexar,04019,Pima,AZ,Tucson,260,5951000,22888.46153846154,196,4717000,24066.326530612245,64,1234000
2016,county,48029,Bexar,04021,Pinal,AZ,Phoenix,57,1085000,19035.087719298244,50,1707000,34140.0,7,-622000
2016,county,48453,Travis,12103,Pinellas,FL,Tampa,161,4930000,30621.11801242236,595,14058000,23626.89075630252,-434,-9128000
2016,county,48029,Bexar,12103,Pinellas,FL,Tampa,78,2157000,27653.846153846152,108,3183000,29472.222222222223,-30,-1026000
2016,county,48453,Travis,12105,Polk,FL,Orlando,187,2364000,12641.711229946524,650,5929000,9121.538461538461,-463,-3565000
2016,county,48453,Travis,19153,Polk,IA,Rural Iowa,59,2297000,38932.20338983051,90,2303000,25588.88888888889,-31,-6000
2016,county,48029,Bexar,19153,Polk,IA,Rural Iowa,45,1222000,27155.555555555555,89,1781000,20011.23595505618,-44,-559000
2016,county,48453,Travis,48375,Potter,TX,Rural Texas,64,1954000,30531.25,46,1392000,30260.869565217392,18,562000
2016,county,48453,Travis,24033,Prince George,MD,Rural Maryland,98,1925000,19642.85714285714,227,4170000,18370.044052863435,-129,-2245000
2016,county,48029,Bexar,24033,Prince George,MD,Rural Maryland,185,5465000,29540.54054054054,98,2834000,28918.367346938776,87,2631000
2016,county,48453,Travis,51153,Prince William,VA,Rural Virginia,77,1908000,24779.22077922078,68,1600000,23529.41176470588,9,308000
2016,county,48029,Bexar,51153,Prince William,VA,Rural Virginia,181,5840000,32265.193370165747,138,3371000,24427.536231884056,43,2469000
2016,county,48453,Travis,44007,Providence,RI,Providence,64,1910000,29843.75,141,2759000,19567.375886524824,-77,-849000
2016,county,48453,Travis,05119,Pulaski,AR,Little Rock,144,4130000,28680.555555555555,165,3010000,18242.424242424244,-21,1120000
2016,county,48029,Bexar,05119,Pulaski,AR,Little Rock,118,3170000,26864.406779661018,88,3052000,34681.818181818184,30,118000
2016,county,48029,Bexar,29169,Pulaski,MO,Rural Missouri,86,1660000,19302.325581395347,56,1096000,19571.428571428572,30,564000
2016,county,48453,Travis,36081,Queens,NY,New York,278,8810000,31690.64748201439,489,9274000,18965.23517382413,-211,-464000
2016,county,48029,Bexar,36081,Queens,NY,New York,135,2723000,20170.37037037037,50,1590000,31800.0,85,1133000
2016,county,48453,Travis,27123,Ramsey,MN,Minneapolis,69,4870000,70579.71014492754,107,3197000,29878.504672897197,-38,1673000
2016,county,48453,Travis,48381,Randall,TX,Rural Texas,69,3094000,44840.57971014493,50,1440000,28800.0,19,1654000
2016,county,48029,Bexar,48381,Randall,TX,Rural Texas,113,3544000,31362.83185840708,102,3044000,29843.13725490196,11,500000
2016,county,48453,Travis,45079,Richland,SC,Columbia,56,1191000,21267.85714285714,83,1822000,21951.807228915663,-27,-631000
2016,county,48029,Bexar,45079,Richland,SC,Columbia,155,3565000,23000.0,96,1965000,20468.75,59,1600000
2016,county,48453,Travis,13245,Richmond,GA,Rural Georgia,36,586000,16277.777777777777,175,1631000,9320.0,-139,-1045000
2016,county,48029,Bexar,13245,Richmond,GA,Rural Georgia,96,2041000,21260.416666666668,95,2051000,21589.473684210527,1,-10000
2016,county,48453,Travis,51760,Richmond city,VA,Richmond,57,4562000,80035.08771929824,103,3108000,30174.757281553397,-46,1454000
2016,county,48029,Bexar,20161,Riley,KS,Rural Kansas,99,2180000,22020.20202020202,61,1705000,27950.819672131147,38,475000
2016,county,48491,Williamson,06065,Riverside,CA,San Bernardino-Riverside,185,5835000,31540.54054054054,116,2668000,23000.0,69,3167000
2016,county,48453,Travis,06065,Riverside,CA,San Bernardino-Riverside,525,9406000,17916.190476190477,626,9919000,15845.047923322683,-101,-513000
2016,county,48029,Bexar,06065,Riverside,CA,San Bernardino-Riverside,345,7434000,21547.82608695652,260,5650000,21730.76923076923,85,1784000
2016,county,48453,Travis,48397,Rockwall,TX,Dallas-Fort Worth,51,1767000,34647.05882352941,66,4083000,61863.63636363636,-15,-2316000
2016,county,48029,Bexar,48397,Rockwall,TX,Dallas-Fort Worth,45,3116000,69244.44444444444,86,2602000,30255.81395348837,-41,514000
2016,county,48453,Travis,47149,Rutherford,TN,Nashville,48,787000,16395.833333333332,55,1156000,21018.18181818182,-7,-369000
2016,county,48491,Williamson,06067,Sacramento,CA,Sacramento,61,3148000,51606.55737704918,44,1431000,32522.727272727272,17,1717000
2016,county,48453,Travis,06067,Sacramento,CA,Sacramento,175,4895000,27971.428571428572,338,7551000,22340.236686390534,-163,-2656000
2016,county,48029,Bexar,06067,Sacramento,CA,Sacramento,146,3985000,27294.520547945205,107,2897000,27074.766355140186,39,1088000
2016,county,48491,Williamson,49035,Salt Lake,UT,Salt Lake,105,3819000,36371.42857142857,66,1809000,27409.090909090908,39,2010000
2016,county,48453,Travis,49035,Salt Lake,UT,Salt Lake,212,7350000,34669.811320754714,255,8874000,34800.0,-43,-1524000
2016,county,48029,Bexar,49035,Salt Lake,UT,Salt Lake,206,4170000,20242.718446601943,160,5325000,33281.25,46,-1155000
2016,county,48453,Travis,06071,San Bernardino,CA,San Bernardino-Riverside,269,5549000,20628.252788104088,476,5801000,12186.974789915967,-207,-252000
2016,county,48029,Bexar,06071,San Bernardino,CA,San Bernardino-Riverside,352,6355000,18053.977272727272,208,3665000,17620.19230769231,144,2690000
2016,county,48491,Williamson,06073,San Diego,CA,San Diego,434,14630000,33709.67741935484,141,4903000,34773.04964539007,293,9727000
2016,county,48453,Travis,06073,San Diego,CA,San Diego,785,39575000,50414.012738853504,707,33836000,47858.55728429986,78,5739000
2016,county,48209,Hays,06073,San Diego,CA,San Diego,131,4501000,34358.7786259542,48,1026000,21375.0,83,3475000
2016,county,48029,Bexar,06073,San Diego,CA,San Diego,933,21873000,23443.729903536976,710,17464000,24597.183098591548,223,4409000
2016,county,48453,Travis,06075,San Francisco,CA,Bay Area,385,35821000,93041.55844155845,368,38094000,103516.30434782608,17,-2273000
2016,county,48029,Bexar,06075,San Francisco,CA,Bay Area,52,2942000,56576.92307692308,39,2223000,57000.0,13,719000
2016,county,48453,Travis,06077,San Joaquin,CA,Bay Area,78,1573000,20166.666666666668,191,3208000,16795.81151832461,-113,-1635000
2016,county,48453,Travis,06079,San Luis Obispo,CA,Rural California,27,951000,35222.22222222222,44,1387000,31522.727272727272,-17,-436000
2016,county,48453,Travis,06081,San Mateo,CA,Bay Area,279,26345000,94426.52329749103,226,31655000,140066.37168141594,53,-5310000
2016,county,48029,Bexar,06081,San Mateo,CA,Bay Area,73,4399000,60260.27397260274,39,2340000,60000.0,34,2059000
2016,county,48453,Travis,48409,San Patricio,TX,Rural Texas,70,1755000,25071.428571428572,53,2114000,39886.79245283019,17,-359000
2016,county,48029,Bexar,48409,San Patricio,TX,Rural Texas,251,5516000,21976.09561752988,132,3149000,23856.060606060608,119,2367000
2016,county,48453,Travis,06083,Santa Barbara,CA,Rural California,77,3549000,46090.90909090909,70,4520000,64571.42857142857,7,-971000
2016,county,48029,Bexar,06083,Santa Barbara,CA,Rural California,106,3153000,29745.283018867925,40,1099000,27475.0,66,2054000
2016,county,48491,Williamson,06085,Santa Clara,CA,Bay Area,415,20020000,48240.96385542169,123,8267000,67211.38211382114,292,11753000
2016,county,48453,Travis,06085,Santa Clara,CA,Bay Area,873,73047000,83673.53951890035,679,66658000,98170.83946980855,194,6389000
2016,county,48029,Bexar,06085,Santa Clara,CA,Bay Area,157,5774000,36777.07006369427,128,6315000,49335.9375,29,-541000
2016,county,48453,Travis,06087,Santa Cruz,CA,Bay Area,56,2273000,40589.28571428572,46,1724000,37478.260869565216,10,549000
2016,county,48453,Travis,35049,Santa Fe,NM,Rural New Mexico,57,2973000,52157.89473684211,67,3535000,52761.19402985075,-10,-562000
2016,county,48453,Travis,12113,Santa Rosa,FL,FL Panhandle,27,672000,24888.88888888889,57,1506000,26421.052631578947,-30,-834000
2016,county,48029,Bexar,12113,Santa Rosa,FL,FL Panhandle,115,3069000,26686.956521739132,108,1938000,17944.444444444445,7,1131000
2016,county,48453,Travis,12115,Sarasota,FL,S.W. Florida,54,3649000,67574.07407407407,127,5159000,40622.04724409449,-73,-1510000
2016,county,48029,Bexar,31153,Sarpy,NE,Omaha,160,3315000,20718.75,110,2313000,21027.272727272728,50,1002000
2016,county,48453,Travis,20173,Sedgwick,KS,Rural Kansas,80,2508000,31350.0,88,1338000,15204.545454545454,-8,1170000
2016,county,48029,Bexar,20173,Sedgwick,KS,Rural Kansas,110,2847000,25881.81818181818,94,1629000,17329.787234042553,16,1218000
2016,county,48453,Travis,12117,Seminole,FL,Orlando,86,2283000,26546.511627906977,257,4143000,16120.622568093386,-171,-1860000
2016,county,48029,Bexar,12117,Seminole,FL,Orlando,51,2153000,42215.686274509804,56,1640000,29285.714285714286,-5,513000
2016,county,48453,Travis,47157,Shelby,TN,Memphis,332,13340000,40180.72289156626,634,9906000,15624.605678233438,-302,3434000
2016,county,48453,Travis,01117,Shelby,AL,Birmingham,39,1090000,27948.71794871795,38,938000,24684.21052631579,1,152000
2016,county,48029,Bexar,47157,Shelby,TN,Memphis,158,3390000,21455.696202531646,123,2517000,20463.414634146342,35,873000
2016,county,48491,Williamson,48423,Smith,TX,Rural Texas,73,2062000,28246.575342465752,73,2523000,34561.643835616436,0,-461000
2016,county,48453,Travis,48423,Smith,TX,Rural Texas,206,6532000,31708.73786407767,160,5280000,33000.0,46,1252000
2016,county,48029,Bexar,48423,Smith,TX,Rural Texas,162,4496000,27753.086419753086,127,2935000,23110.23622047244,35,1561000
2016,county,48453,Travis,53061,Snohomish,WA,Seattle,70,2638000,37685.71428571428,121,3714000,30694.214876033056,-51,-1076000
2016,county,48029,Bexar,53061,Snohomish,WA,Seattle,82,1691000,20621.951219512193,93,3052000,32817.20430107527,-11,-1361000
2016,county,48453,Travis,06095,Solano,CA,Bay Area,69,1745000,25289.855072463768,84,1439000,17130.95238095238,-15,306000
2016,county,48029,Bexar,06095,Solano,CA,Bay Area,236,5723000,24250.0,142,3850000,27112.676056338027,94,1873000
2016,county,48453,Travis,06097,Sonoma,CA,Bay Area,40,2784000,69600.0,66,2597000,39348.48484848485,-26,187000
2016,county,48453,Travis,53063,Spokane,WA,Spokane,48,1736000,36166.666666666664,67,1761000,26283.582089552237,-19,-25000
2016,county,48029,Bexar,53063,Spokane,WA,Spokane,107,2577000,24084.11214953271,86,2216000,25767.441860465115,21,361000
2016,county,48453,Travis,29183,St. Charles,MO,St. Louis,37,1142000,30864.864864864863,89,2878000,32337.078651685395,-52,-1736000
2016,county,48453,Travis,17163,St. Clair,IL,St. Louis,32,1143000,35718.75,50,1275000,25500.0,-18,-132000
2016,county,48029,Bexar,17163,St. Clair,IL,St. Louis,175,4883000,27902.85714285714,86,2160000,25116.279069767443,89,2723000
2016,county,48453,Travis,18141,St. Joseph,IN,Rural Indiana,53,1140000,21509.43396226415,74,675000,9121.621621621622,-21,465000
2016,county,48453,Travis,29189,St. Louis,MO,St. Louis,137,6706000,48948.90510948905,342,12814000,37467.836257309944,-205,-6108000
2016,county,48029,Bexar,29189,St. Louis,MO,St. Louis,105,3702000,35257.142857142855,106,4435000,41839.622641509435,-1,-733000
2016,county,48453,Travis,29510,St. Louis city,MO,Rural Missouri,85,3177000,37376.470588235294,142,2186000,15394.366197183099,-57,991000
2016,county,48029,Bexar,29510,St. Louis city,MO,Rural Missouri,50,1295000,25900.0,34,718000,21117.647058823528,16,577000
2016,county,48453,Travis,12111,St. Lucie,FL,Atlantic Coast,49,583000,11897.959183673469,126,1970000,15634.920634920634,-77,-1387000
2016,county,48453,Travis,22103,St. Tammany Parish,LA,New Orleans,38,1084000,28526.315789473683,53,1146000,21622.64150943396,-15,-62000
2016,county,48453,Travis,06099,Stanislaus,CA,Bay Area,35,988000,28228.571428571428,104,1077000,10355.76923076923,-69,-89000
2016,county,48453,Travis,25025,Suffolk,MA,Boston,186,19517000,104930.10752688172,227,10935000,48171.80616740088,-41,8582000
2016,county,48453,Travis,36103,Suffolk,NY,New York,181,4582000,25314.91712707182,228,5045000,22127.19298245614,-47,-463000
2016,county,48029,Bexar,25025,Suffolk,MA,Boston,59,2406000,40779.661016949154,49,1587000,32387.755102040817,10,819000
2016,county,48453,Travis,39153,Summit,OH,Rural Ohio,52,2101000,40403.846153846156,79,1053000,13329.113924050633,-27,1048000
2016,county,48491,Williamson,48439,Tarrant,TX,Dallas-Fort Worth,559,20337000,36381.03756708408,500,16077000,32154.0,59,4260000
2016,county,48453,Travis,48439,Tarrant,TX,Dallas-Fort Worth,1249,47663000,38160.928742994394,1488,54361000,36532.93010752688,-239,-6698000
2016,county,48209,Hays,48439,Tarrant,TX,Dallas-Fort Worth,203,6281000,30940.886699507388,159,4518000,28415.094339622643,44,1763000
2016,county,48091,Comal,48439,Tarrant,TX,Dallas-Fort Worth,181,7852000,43381.21546961326,99,2740000,27676.76767676768,82,5112000
2016,county,48029,Bexar,48439,Tarrant,TX,Dallas-Fort Worth,1034,29400000,28433.268858800773,1239,37196000,30020.984665052463,-205,-7796000
2016,county,48491,Williamson,48441,Taylor,TX,Rural Texas,113,2611000,23106.194690265485,58,1443000,24879.310344827587,55,1168000
2016,county,48453,Travis,48441,Taylor,TX,Rural Texas,149,4710000,31610.738255033557,84,1417000,16869.04761904762,65,3293000
2016,county,48029,Bexar,48441,Taylor,TX,Rural Texas,263,5434000,20661.596958174905,144,3021000,20979.166666666668,119,2413000
2016,county,48453,Travis,53067,Thurston,WA,Rural Washington,32,1216000,38000.0,71,2968000,41802.81690140845,-39,-1752000
2016,county,48029,Bexar,53067,Thurston,WA,Rural Washington,131,2594000,19801.52671755725,82,2360000,28780.48780487805,49,234000
2016,county,48491,Williamson,48451,Tom Green,TX,Rural Texas,114,2300000,20175.43859649123,62,1811000,29209.677419354837,52,489000
2016,county,48453,Travis,48451,Tom Green,TX,Rural Texas,154,5645000,36655.844155844155,131,2533000,19335.87786259542,23,3112000
2016,county,48029,Bexar,48451,Tom Green,TX,Rural Texas,457,9708000,21242.88840262582,242,6000000,24793.388429752067,215,3708000
2016,county,48491,Williamson,48453,Travis,TX,Austin,19122,626750000,32776.38322351219,12721,450789000,35436.600896155964,6401,175961000
2016,county,48209,Hays,48453,Travis,TX,Austin,7403,235088000,31755.774685938133,3479,139397000,40068.12302385743,3924,95691000
2016,county,48091,Comal,48453,Travis,TX,Austin,473,16963000,35862.579281183935,318,13146000,41339.622641509435,155,3817000
2016,county,48029,Bexar,48453,Travis,TX,Austin,2497,71677000,28705.246295554665,2556,95539000,37378.3255086072,-59,-23862000
2016,county,48453,Travis,06107,Tulare,CA,Rural California,54,675000,12500.0,57,630000,11052.631578947368,-3,45000
2016,county,48453,Travis,40143,Tulsa,OK,Tulsa,119,8915000,74915.96638655462,276,12020000,43550.72463768116,-157,-3105000
2016,county,48029,Bexar,40143,Tulsa,OK,Tulsa,100,3581000,35810.0,92,2243000,24380.434782608696,8,1338000
2016,county,48453,Travis,34039,Union,NJ,New York,53,1390000,26226.415094339623,117,3984000,34051.282051282054,-64,-2594000
2016,county,48491,Williamson,49049,Utah,UT,Rural Utah,130,2540000,19538.46153846154,62,1335000,21532.25806451613,68,1205000
2016,county,48453,Travis,49049,Utah,UT,Rural Utah,117,2510000,21452.991452991453,135,3618000,26800.0,-18,-1108000
2016,county,48029,Bexar,49049,Utah,UT,Rural Utah,133,1947000,14639.097744360903,106,2575000,24292.45283018868,27,-628000
2016,county,48029,Bexar,48463,Uvalde,TX,Rural Texas,289,5177000,17913.494809688582,178,3067000,17230.337078651686,111,2110000
2016,county,48453,Travis,48465,Val Verde,TX,Rural Texas,36,700000,19444.444444444445,42,779000,18547.619047619046,-6,-79000
2016,county,48029,Bexar,48465,Val Verde,TX,Rural Texas,428,9355000,21857.47663551402,248,5505000,22197.58064516129,180,3850000
2016,county,48453,Travis,06111,Ventura,CA,Los Angeles,186,7807000,41973.11827956989,118,3824000,32406.77966101695,68,3983000
2016,county,48029,Bexar,06111,Ventura,CA,Los Angeles,120,2202000,18350.0,56,1444000,25785.714285714286,64,758000
2016,county,48029,Bexar,22115,Vernon Parish,LA,Rural Louisiana,150,2355000,15700.0,76,1378000,18131.57894736842,74,977000
2016,county,48491,Williamson,48469,Victoria,TX,Rural Texas,66,1588000,24060.60606060606,46,1799000,39108.69565217391,20,-211000
2016,county,48453,Travis,48469,Victoria,TX,Rural Texas,148,5188000,35054.05405405405,104,2242000,21557.69230769231,44,2946000
2016,county,48209,Hays,48469,Victoria,TX,Rural Texas,65,1519000,23369.23076923077,38,1405000,36973.68421052631,27,114000
2016,county,48029,Bexar,48469,Victoria,TX,Rural Texas,226,5862000,25938.05309734513,156,3339000,21403.846153846152,70,2523000
2016,county,48453,Travis,51810,Virginia Beach city,VA,Hampton Roads,73,2382000,32630.13698630137,87,5232000,60137.93103448276,-14,-2850000
2016,county,48029,Bexar,51810,Virginia Beach city,VA,Hampton Roads,140,2925000,20892.85714285714,160,2872000,17950.0,-20,53000
2016,county,48453,Travis,12127,Volusia,FL,Atlantic Coast,85,1495000,17588.235294117647,233,3132000,13442.06008583691,-148,-1637000
2016,county,48491,Williamson,37183,Wake,NC,Raleigh,88,4863000,55261.36363636364,56,2015000,35982.142857142855,32,2848000
2016,county,48453,Travis,37183,Wake,NC,Raleigh,244,14088000,57737.70491803279,354,7281000,20567.79661016949,-110,6807000
2016,county,48029,Bexar,37183,Wake,NC,Raleigh,137,4307000,31437.956204379563,88,3451000,39215.90909090909,49,856000
2016,county,48453,Travis,48471,Walker,TX,Rural Texas,72,2108000,29277.777777777777,41,1009000,24609.756097560974,31,1099000
2016,county,48029,Bexar,38101,Ward,ND,Rural North Dakota,89,1623000,18235.955056179777,51,1200000,23529.41176470588,38,423000
2016,county,48491,Williamson,41067,Washington,OR,Portland,127,5354000,42157.48031496063,49,2439000,49775.510204081635,78,2915000
2016,county,48453,Travis,41067,Washington,OR,Portland,154,7229000,46941.55844155844,200,6438000,32190.0,-46,791000
2016,county,48453,Travis,05143,Washington,AR,Rural Arkansas,69,1069000,15492.753623188406,73,3812000,52219.17808219178,-4,-2743000
2016,county,48453,Travis,48477,Washington,TX,Rural Texas,49,1490000,30408.163265306124,50,1559000,31180.0,-1,-69000
2016,county,48029,Bexar,41067,Washington,OR,Portland,74,3107000,41986.48648648649,63,1630000,25873.015873015873,11,1477000
2016,county,48453,Travis,32031,Washoe,NV,Rural Nevada,79,2432000,30784.810126582277,92,3543000,38510.86956521739,-13,-1111000
2016,county,48029,Bexar,32031,Washoe,NV,Rural Nevada,61,1852000,30360.655737704918,57,1340000,23508.77192982456,4,512000
2016,county,48453,Travis,26161,Washtenaw,MI,Rural Michigan,88,3628000,41227.27272727273,93,4451000,47860.215053763444,-5,-823000
2016,county,48453,Travis,55133,Waukesha,WI,Milwaukee,60,3084000,51400.0,34,1038000,30529.41176470588,26,2046000
2016,county,48453,Travis,26163,Wayne,MI,Detroit,365,5311000,14550.684931506848,1191,14276000,11986.565910999161,-826,-8965000
2016,county,48029,Bexar,26163,Wayne,MI,Detroit,112,2131000,19026.785714285714,65,1920000,29538.46153846154,47,211000
2016,county,48453,Travis,48479,Webb,TX,Rural Texas,262,5193000,19820.6106870229,187,3046000,16288.770053475935,75,2147000
2016,county,48029,Bexar,48479,Webb,TX,Rural Texas,1508,30710000,20364.72148541114,665,12655000,19030.075187969924,843,18055000
2016,county,48453,Travis,08123,Weld,CO,Rural Colorado,40,1042000,26050.0,50,1170000,23400.0,-10,-128000
2016,county,48453,Travis,36119,Westchester,NY,New York,160,9619000,60118.75,253,32388000,128015.81027667984,-93,-22769000
2016,county,48453,Travis,48481,Wharton,TX,Rural Texas,42,1029000,24500.0,37,1020000,27567.567567567567,5,9000
2016,county,48491,Williamson,48485,Wichita,TX,Rural Texas,31,804000,25935.483870967742,36,870000,24166.666666666668,-5,-66000
2016,county,48453,Travis,48485,Wichita,TX,Rural Texas,84,2594000,30880.95238095238,91,1907000,20956.043956043955,-7,687000
2016,county,48029,Bexar,48485,Wichita,TX,Rural Texas,155,3550000,22903.225806451614,116,2272000,19586.206896551725,39,1278000
2016,county,48453,Travis,17197,Will,IL,Chicago,65,2110000,32461.53846153846,77,3436000,44623.37662337662,-12,-1326000
2016,county,48453,Travis,48491,Williamson,TX,Austin,12721,450789000,35436.600896155964,19122,626750000,32776.38322351219,-6401,-175961000
2016,county,48453,Travis,47187,Williamson,TN,Nashville,49,2622000,53510.204081632655,70,4790000,68428.57142857143,-21,-2168000
2016,county,48209,Hays,48491,Williamson,TX,Austin,644,18467000,28675.465838509317,595,20569000,34569.747899159665,49,-2102000
2016,county,48091,Comal,48491,Williamson,TX,Austin,169,6262000,37053.25443786982,150,4456000,29706.666666666668,19,1806000
2016,county,48029,Bexar,48491,Williamson,TX,Austin,761,24181000,31775.295663600526,982,29775000,30320.773930753563,-221,-5594000
2016,county,48091,Comal,48493,Wilson,TX,Rural Texas,82,3821000,46597.560975609755,56,2183000,38982.142857142855,26,1638000
2016,county,48029,Bexar,48493,Wilson,TX,Rural Texas,923,29576000,32043.336944745395,1318,34466000,26150.227617602428,-395,-4890000
2016,county,48453,Travis,25027,Worcester,MA,Rural Massachusetts,82,3595000,43841.46341463415,143,3447000,24104.895104895106,-61,148000
2016,county,48029,Bexar,51199,York,VA,Hampton Roads,99,2625000,26515.151515151516,94,1839000,19563.82978723404,5,786000
2016,county,48029,Bexar,48507,Zavala,TX,Rural Texas,100,2071000,20710.0,48,933000,19437.5,52,1138000
2016,total,48491,Williamson,96000,,,,46294,1571208000,33939.77621290016,32210,1057586000,32834.08879230053,14084,513622000
2016,total,48453,Travis,96000,,,,89270,3576031000,40058.59751316232,146966,4746945000,32299.613516051333,-57696,-1170914000
2016,total,48209,Hays,96000,,,,17937,603597000,33650.94497407593,12628,389200000,30820.39911308204,5309,214397000
2016,total,48091,Comal,96000,,,,13290,515876000,38816.854778028595,8981,286652000,31917.603830308428,4309,229224000
2016,total,48029,Bexar,96000,,,,81310,2201293000,27072.844668552454,72282,2146092000,29690.545363991034,9028,55201000
2017,county,48453,Travis,16001,Ada,ID,Rural Idaho,108,7529000,69712.96296296296,101,3114000,30831.68316831683,7,4415000
2017,county,48029,Bexar,16001,Ada,ID,Rural Idaho,84,1734000,20642.85714285714,86,2445000,28430.232558139534,-2,-711000
2017,county,48491,Williamson,08001,Adams,CO,Denver,46,1385000,30108.695652173912,36,1187000,32972.22222222222,10,198000
2017,county,48453,Travis,08001,Adams,CO,Denver,60,2218000,36966.666666666664,115,5758000,50069.565217391304,-55,-3540000
2017,county,48029,Bexar,08001,Adams,CO,Denver,159,3999000,25150.943396226416,99,2929000,29585.858585858587,60,1070000
2017,county,48453,Travis,12001,Alachua,FL,Rural Florida,116,3040000,26206.896551724138,72,2392000,33222.22222222222,44,648000
2017,county,48491,Williamson,06001,Alameda,CA,Bay Area,309,18572000,60103.55987055016,52,1941000,37326.92307692308,257,16631000
2017,county,48453,Travis,06001,Alameda,CA,Bay Area,725,47215000,65124.137931034486,394,21114000,53588.83248730964,331,26101000
2017,county,48029,Bexar,06001,Alameda,CA,Bay Area,180,9497000,52761.11111111111,168,7938000,47250.0,12,1559000
2017,county,48453,Travis,36001,Albany,NY,Rural New York,49,2056000,41959.183673469386,48,2298000,47875.0,1,-242000
2017,county,48453,Travis,51510,Alexandria city,VA,D.C.,93,6692000,71956.98924731182,70,4900000,70000.0,23,1792000
2017,county,48029,Bexar,51510,Alexandria city,VA,D.C.,88,4355000,49488.63636363636,114,5772000,50631.57894736842,-26,-1417000
2017,county,48491,Williamson,42003,Allegheny,PA,Pittsburgh,43,1512000,35162.79069767442,45,1672000,37155.555555555555,-2,-160000
2017,county,48453,Travis,42003,Allegheny,PA,Pittsburgh,174,9382000,53919.54022988506,154,5093000,33071.42857142857,20,4289000
2017,county,48029,Bexar,42003,Allegheny,PA,Pittsburgh,117,5549000,47427.35042735043,85,3258000,38329.41176470588,32,2291000
2017,county,48453,Travis,18003,Allen,IN,Rural Indiana,31,786000,25354.83870967742,41,894000,21804.878048780487,-10,-108000
2017,county,48029,Bexar,18003,Allen,IN,Rural Indiana,49,1458000,29755.102040816328,48,770000,16041.666666666666,1,688000
2017,county,48453,Travis,02020,Anchorage Borough,AK,Rural Alaska,78,3391000,43474.35897435898,53,2370000,44716.981132075474,25,1021000
2017,county,48029,Bexar,02020,Anchorage Borough,AK,Rural Alaska,362,9660000,26685.08287292818,168,4194000,24964.285714285714,194,5466000
2017,county,48453,Travis,48005,Angelina,TX,Rural Texas,54,1587000,29388.88888888889,44,2049000,46568.181818181816,10,-462000
2017,county,48453,Travis,24003,Anne Arundel,MD,Baltimore,63,4293000,68142.85714285714,64,2238000,34968.75,-1,2055000
2017,county,48029,Bexar,24003,Anne Arundel,MD,Baltimore,489,14549000,29752.556237218814,434,11543000,26596.774193548386,55,3006000
2017,county,48491,Williamson,48007,Aransas,TX,Rural Texas,36,1536000,42666.666666666664,42,3388000,80666.66666666667,-6,-1852000
2017,county,48453,Travis,48007,Aransas,TX,Rural Texas,53,1257000,23716.98113207547,63,4599000,73000.0,-10,-3342000
2017,county,48029,Bexar,48007,Aransas,TX,Rural Texas,105,3497000,33304.76190476191,160,5768000,36050.0,-55,-2271000
2017,county,48491,Williamson,08005,Arapahoe,CO,Denver,102,4733000,46401.96078431373,99,3352000,33858.58585858586,3,1381000
2017,county,48453,Travis,08005,Arapahoe,CO,Denver,200,7337000,36685.0,215,9588000,44595.348837209305,-15,-2251000
2017,county,48029,Bexar,08005,Arapahoe,CO,Denver,337,9524000,28261.127596439168,289,8492000,29384.083044982697,48,1032000
2017,county,48453,Travis,51013,Arlington,VA,D.C.,153,10985000,71797.38562091504,102,6342000,62176.470588235294,51,4643000
2017,county,48029,Bexar,51013,Arlington,VA,D.C.,119,7335000,61638.65546218488,71,4533000,63845.07042253521,48,2802000
2017,county,48453,Travis,48013,Atascosa,TX,Rural Texas,32,1112000,34750.0,43,1174000,27302.325581395347,-11,-62000
2017,county,48091,Comal,48013,Atascosa,TX,Rural Texas,41,1551000,37829.26829268293,45,1455000,32333.333333333332,-4,96000
2017,county,48029,Bexar,48013,Atascosa,TX,Rural Texas,1376,26413000,19195.49418604651,2071,38169000,18430.226943505553,-695,-11756000
2017,county,48453,Travis,01003,Baldwin,AL,Mobile,49,1138000,23224.48979591837,35,1102000,31485.714285714286,14,36000
2017,county,48453,Travis,24005,Baltimore,MD,Baltimore,113,3848000,34053.097345132745,94,3687000,39223.40425531915,19,161000
2017,county,48029,Bexar,24005,Baltimore,MD,Baltimore,85,2992000,35200.0,44,1472000,33454.545454545456,41,1520000
2017,county,48453,Travis,24510,Baltimore city,MD,Baltimore,140,6801000,48578.57142857143,90,2558000,28422.222222222223,50,4243000
2017,county,48029,Bexar,24510,Baltimore city,MD,Baltimore,61,3112000,51016.39344262295,49,1851000,37775.510204081635,12,1261000
2017,county,48029,Bexar,48019,Bandera,TX,Rural Texas,379,10030000,26464.37994722955,821,24565000,29920.82825822168,-442,-14535000
2017,county,48491,Williamson,48021,Bastrop,TX,Austin,419,11613000,27715.99045346062,718,17674000,24615.598885793872,-299,-6061000
2017,county,48453,Travis,48021,Bastrop,TX,Austin,1791,37118000,20724.734785036293,4075,82808000,20320.981595092024,-2284,-45690000
2017,county,48209,Hays,48021,Bastrop,TX,Austin,290,5832000,20110.344827586207,320,7878000,24618.75,-30,-2046000
2017,county,48091,Comal,48021,Bastrop,TX,Austin,45,1461000,32466.666666666668,42,1326000,31571.428571428572,3,135000
2017,county,48029,Bexar,48021,Bastrop,TX,Austin,118,2530000,21440.677966101695,116,3565000,30732.758620689656,2,-1035000
2017,county,48453,Travis,12005,Bay,FL,FL Panhandle,56,1100000,19642.85714285714,40,1341000,33525.0,16,-241000
2017,county,48029,Bexar,12005,Bay,FL,FL Panhandle,197,3844000,19512.69035532995,85,2816000,33129.41176470588,112,1028000
2017,county,48029,Bexar,45013,Beaufort,SC,Savannah,76,1551000,20407.894736842107,53,2414000,45547.16981132075,23,-863000
2017,county,48029,Bexar,48025,Bee,TX,Rural Texas,175,4360000,24914.285714285714,113,1637000,14486.725663716814,62,2723000
2017,county,48491,Williamson,48027,Bell,TX,Rural Texas,1601,46481000,29032.47970018738,2249,53719000,23885.726989773233,-648,-7238000
2017,county,48453,Travis,48027,Bell,TX,Rural Texas,1130,28219000,24972.566371681416,2008,33836000,16850.59760956175,-878,-5617000
2017,county,48209,Hays,48027,Bell,TX,Rural Texas,223,5662000,25390.13452914798,188,2910000,15478.72340425532,35,2752000
2017,county,48091,Comal,48027,Bell,TX,Rural Texas,97,2434000,25092.78350515464,81,2120000,26172.83950617284,16,314000
2017,county,48029,Bexar,48027,Bell,TX,Rural Texas,1366,28565000,20911.42020497804,918,19488000,21228.75816993464,448,9077000
2017,county,48491,Williamson,05007,Benton,AR,Rural Arkansas,61,2523000,41360.65573770492,48,2224000,46333.333333333336,13,299000
2017,county,48453,Travis,05007,Benton,AR,Rural Arkansas,42,1795000,42738.09523809524,96,5151000,53656.25,-54,-3356000
2017,county,48029,Bexar,05007,Benton,AR,Rural Arkansas,64,1706000,26656.25,75,2533000,33773.333333333336,-11,-827000
2017,county,48453,Travis,34003,Bergen,NJ,New York,95,5199000,54726.31578947369,49,1813000,37000.0,46,3386000
2017,county,48029,Bexar,45015,Berkeley,SC,Charleston,71,1346000,18957.74647887324,59,1250000,21186.4406779661,12,96000
2017,county,48491,Williamson,35001,Bernalillo,NM,Albuquerque,133,5929000,44578.94736842105,52,1391000,26750.0,81,4538000
2017,county,48453,Travis,35001,Bernalillo,NM,Albuquerque,257,11937000,46447.47081712062,169,11273000,66704.14201183432,88,664000
2017,county,48029,Bexar,35001,Bernalillo,NM,Albuquerque,328,8034000,24493.90243902439,248,7230000,29153.225806451614,80,804000
2017,county,48491,Williamson,48029,Bexar,TX,San Antonio,1251,39299000,31414.068745003995,962,28992000,30137.214137214138,289,10307000
2017,county,48453,Travis,48029,Bexar,TX,San Antonio,3239,143077000,44173.20160543377,3182,106527000,33478.001257071024,57,36550000
2017,county,48209,Hays,48029,Bexar,TX,San Antonio,925,25094000,27128.64864864865,929,22069000,23755.651237890204,-4,3025000
2017,county,48091,Comal,48029,Bexar,TX,San Antonio,5185,195792000,37761.234329797495,2261,78996000,34938.52277753207,2924,116796000
2017,county,48453,Travis,48031,Blanco,TX,Rural Texas,52,1885000,36250.0,145,11525000,79482.75862068965,-93,-9640000
2017,county,48209,Hays,48031,Blanco,TX,Rural Texas,56,1809000,32303.571428571428,120,4225000,35208.333333333336,-64,-2416000
2017,county,48091,Comal,48031,Blanco,TX,Rural Texas,85,1431000,16835.29411764706,74,1685000,22770.27027027027,11,-254000
2017,county,48029,Bexar,48031,Blanco,TX,Rural Texas,71,1384000,19492.957746478874,88,2833000,32193.18181818182,-17,-1449000
2017,county,48453,Travis,29019,Boone,MO,Columbia,45,1087000,24155.555555555555,29,841000,29000.0,16,246000
2017,county,48029,Bexar,22015,Bossier Parish,LA,Rural Louisiana,221,4758000,21529.41176470588,127,3100000,24409.44881889764,94,1658000
2017,county,48453,Travis,08013,Boulder,CO,Denver,154,7401000,48058.44155844156,247,10707000,43348.17813765182,-93,-3306000
2017,county,48029,Bexar,08013,Boulder,CO,Denver,38,1380000,36315.78947368421,83,3525000,42469.87951807229,-45,-2145000
2017,county,48453,Travis,48037,Bowie,TX,Rural Texas,53,1078000,20339.622641509435,44,980000,22272.727272727272,9,98000
2017,county,48491,Williamson,48039,Brazoria,TX,Houston,196,12144000,61959.183673469386,129,4479000,34720.93023255814,67,7665000
2017,county,48453,Travis,48039,Brazoria,TX,Houston,251,9535000,37988.04780876494,167,4605000,27574.850299401198,84,4930000
2017,county,48209,Hays,48039,Brazoria,TX,Houston,101,3608000,35722.77227722772,72,2764000,38388.88888888889,29,844000
2017,county,48091,Comal,48039,Brazoria,TX,Houston,146,6852000,46931.50684931507,33,1305000,39545.454545454544,113,5547000
2017,county,48029,Bexar,48039,Brazoria,TX,Houston,322,10272000,31900.621118012423,305,9450000,30983.60655737705,17,822000
2017,county,48491,Williamson,48041,Brazos,TX,Rural Texas,376,10815000,28763.297872340427,213,6063000,28464.788732394365,163,4752000
2017,county,48453,Travis,48041,Brazos,TX,Rural Texas,644,20330000,31568.32298136646,350,11117000,31762.85714285714,294,9213000
2017,county,48209,Hays,48041,Brazos,TX,Rural Texas,136,3077000,22625.0,89,3082000,34629.213483146064,47,-5000
2017,county,48091,Comal,48041,Brazos,TX,Rural Texas,89,2713000,30483.14606741573,33,1830000,55454.545454545456,56,883000
2017,county,48029,Bexar,48041,Brazos,TX,Rural Texas,442,11617000,26282.805429864253,323,8335000,25804.953560371516,119,3282000
2017,county,48453,Travis,12009,Brevard,FL,Atlantic Coast,82,2378000,29000.0,86,2117000,24616.279069767443,-4,261000
2017,county,48029,Bexar,12009,Brevard,FL,Atlantic Coast,146,3748000,25671.23287671233,220,5402000,24554.545454545456,-74,-1654000
2017,county,48029,Bexar,48043,Brewster,TX,Rural Texas,48,1376000,28666.666666666668,41,1315000,32073.170731707316,7,61000
2017,county,48453,Travis,36005,Bronx,NY,New York,203,3701000,18231.527093596058,143,1971000,13783.216783216783,60,1730000
2017,county,48029,Bexar,36005,Bronx,NY,New York,90,1860000,20666.666666666668,36,643000,17861.11111111111,54,1217000
2017,county,48453,Travis,08014,Broomfield,CO,Denver,36,1447000,40194.444444444445,36,1704000,47333.333333333336,0,-257000
2017,county,48491,Williamson,12011,Broward,FL,Miami,128,4882000,38140.625,48,2079000,43312.5,80,2803000
2017,county,48453,Travis,12011,Broward,FL,Miami,525,15047000,28660.95238095238,552,12269000,22226.44927536232,-27,2778000
2017,county,48029,Bexar,12011,Broward,FL,Miami,323,12109000,37489.164086687306,173,5431000,31393.06358381503,150,6678000
2017,county,48453,Travis,48049,Brown,TX,Rural Texas,39,1098000,28153.846153846152,65,1530000,23538.46153846154,-26,-432000
2017,county,48029,Bexar,48049,Brown,TX,Rural Texas,56,1441000,25732.14285714286,49,974000,19877.551020408162,7,467000
2017,county,48453,Travis,37021,Buncombe,NC,Asheville,60,2491000,41516.666666666664,124,5331000,42991.93548387097,-64,-2840000
2017,county,48029,Bexar,34005,Burlington,NJ,Philadelphia,140,3108000,22200.0,139,3309000,23805.755395683453,1,-201000
2017,county,48491,Williamson,48053,Burnet,TX,Rural Texas,470,15116000,32161.702127659573,969,43962000,45368.42105263158,-499,-28846000
2017,county,48453,Travis,48053,Burnet,TX,Rural Texas,401,20692000,51600.99750623442,815,37481000,45988.95705521473,-414,-16789000
2017,county,48209,Hays,48053,Burnet,TX,Rural Texas,83,2423000,29192.77108433735,97,2448000,25237.113402061856,-14,-25000
2017,county,48029,Bexar,48053,Burnet,TX,Rural Texas,77,2092000,27168.83116883117,154,9155000,59448.05194805195,-77,-7063000
2017,county,48453,Travis,22017,Caddo Parish,LA,Rural Louisiana,66,1873000,28378.78787878788,44,741000,16840.909090909092,22,1132000
2017,county,48029,Bexar,22017,Caddo Parish,LA,Rural Louisiana,127,3835000,30196.850393700788,39,683000,17512.82051282051,88,3152000
2017,county,48453,Travis,22019,Calcasieu Parish,LA,Rural Louisiana,54,1132000,20962.962962962964,50,1221000,24420.0,4,-89000
2017,county,48029,Bexar,22019,Calcasieu Parish,LA,Rural Louisiana,53,712000,13433.962264150943,66,1669000,25287.878787878788,-13,-957000
2017,county,48491,Williamson,48055,Caldwell,TX,Rural Texas,107,2348000,21943.92523364486,138,4030000,29202.898550724636,-31,-1682000
2017,county,48453,Travis,48055,Caldwell,TX,Rural Texas,393,7953000,20236.641221374044,1760,27029000,15357.386363636364,-1367,-19076000
2017,county,48209,Hays,48055,Caldwell,TX,Rural Texas,682,13225000,19391.49560117302,1044,18683000,17895.5938697318,-362,-5458000
2017,county,48091,Comal,48055,Caldwell,TX,Rural Texas,75,1868000,24906.666666666668,81,2051000,25320.987654320987,-6,-183000
2017,county,48029,Bexar,48055,Caldwell,TX,Rural Texas,111,2249000,20261.26126126126,99,2153000,21747.47474747475,12,96000
2017,county,48453,Travis,34007,Camden,NJ,Philadelphia,30,1008000,33600.0,48,941000,19604.166666666668,-18,67000
2017,county,48491,Williamson,48061,Cameron,TX,Rural Texas,198,4296000,21696.969696969696,119,3264000,27428.571428571428,79,1032000
2017,county,48453,Travis,48061,Cameron,TX,Rural Texas,426,10737000,25204.225352112677,306,6405000,20931.37254901961,120,4332000
2017,county,48209,Hays,48061,Cameron,TX,Rural Texas,99,1772000,17898.989898989897,42,955000,22738.095238095237,57,817000
2017,county,48029,Bexar,48061,Cameron,TX,Rural Texas,1389,26111000,18798.416126709864,675,13446000,19920.0,714,12665000
2017,county,48029,Bexar,30013,Cascade,MT,Rural Montana,135,2938000,21762.962962962964,50,728000,14560.0,85,2210000
2017,county,48453,Travis,17019,Champaign,IL,Rural Illinois,162,13818000,85296.29629629629,46,945000,20543.478260869564,116,12873000
2017,county,48029,Bexar,24017,Charles,MD,Rural Maryland,49,1452000,29632.65306122449,56,1075000,19196.428571428572,-7,377000
2017,county,48453,Travis,45019,Charleston,SC,Charleston,63,3196000,50730.15873015873,99,3859000,38979.79797979798,-36,-663000
2017,county,48029,Bexar,45019,Charleston,SC,Charleston,98,3393000,34622.448979591834,82,2730000,33292.68292682927,16,663000
2017,county,48453,Travis,13051,Chatham,GA,Savannah,79,2248000,28455.696202531646,77,1191000,15467.532467532468,2,1057000
2017,county,48029,Bexar,13051,Chatham,GA,Savannah,95,3214000,33831.57894736842,67,1678000,25044.776119402984,28,1536000
2017,county,48029,Bexar,51550,Chesapeake city,VA,Hampton Roads,171,4695000,27456.140350877195,94,2235000,23776.59574468085,77,2460000
2017,county,48453,Travis,42029,Chester,PA,Philadelphia,57,5468000,95929.82456140351,69,2895000,41956.52173913043,-12,2573000
2017,county,48029,Bexar,51041,Chesterfield,VA,Richmond,54,1679000,31092.59259259259,56,1777000,31732.14285714286,-2,-98000
2017,county,48453,Travis,50007,Chittenden,VT,Rural Vermont,40,1475000,36875.0,27,1144000,42370.37037037037,13,331000
2017,county,48453,Travis,41005,Clackamas,OR,Portland,62,5738000,92548.3870967742,50,2455000,49100.0,12,3283000
2017,county,48029,Bexar,41005,Clackamas,OR,Portland,43,1415000,32906.976744186046,60,2422000,40366.666666666664,-17,-1007000
2017,county,48491,Williamson,32003,Clark,NV,Las Vegas,332,10249000,30870.481927710844,164,6077000,37054.87804878049,168,4172000
2017,county,48453,Travis,32003,Clark,NV,Las Vegas,479,25443000,53116.910229645095,427,14421000,33772.8337236534,52,11022000
2017,county,48453,Travis,53011,Clark,WA,Portland,65,2198000,33815.38461538462,106,4378000,41301.88679245283,-41,-2180000
2017,county,48209,Hays,32003,Clark,NV,Las Vegas,64,1993000,31140.625,52,1289000,24788.46153846154,12,704000
2017,county,48029,Bexar,32003,Clark,NV,Las Vegas,792,19731000,24912.878787878788,791,21674000,27400.758533501896,1,-1943000
2017,county,48029,Bexar,53011,Clark,WA,Portland,94,2514000,26744.68085106383,48,1744000,36333.333333333336,46,770000
2017,county,48029,Bexar,12019,Clay,FL,Jacksonville,56,2128000,38000.0,85,1771000,20835.29411764706,-29,357000
2017,county,48453,Travis,40027,Cleveland,OK,Oklahoma City,59,1420000,24067.79661016949,52,1667000,32057.69230769231,7,-247000
2017,county,48029,Bexar,40027,Cleveland,OK,Oklahoma City,133,3399000,25556.39097744361,112,2644000,23607.14285714286,21,755000
2017,county,48491,Williamson,13067,Cobb,GA,Atlanta,92,3008000,32695.652173913044,43,2132000,49581.395348837206,49,876000
2017,county,48453,Travis,13067,Cobb,GA,Atlanta,164,10655000,64969.51219512195,211,6608000,31317.535545023697,-47,4047000
2017,county,48029,Bexar,13067,Cobb,GA,Atlanta,109,3071000,28174.311926605504,126,3939000,31261.904761904763,-17,-868000
2017,county,48029,Bexar,04003,Cochise,AZ,Rural Arizona,173,4443000,25682.08092485549,142,2881000,20288.732394366198,31,1562000
2017,county,48453,Travis,04005,Coconino,AZ,Rural Arizona,31,940000,30322.58064516129,45,1528000,33955.555555555555,-14,-588000
2017,county,48453,Travis,12021,Collier,FL,S.W. Florida,88,4362000,49568.181818181816,75,2990000,39866.666666666664,13,1372000
2017,county,48029,Bexar,12021,Collier,FL,S.W. Florida,38,1185000,31184.21052631579,50,1526000,30520.0,-12,-341000
2017,county,48491,Williamson,48085,Collin,TX,Dallas-Fort Worth,615,23447000,38125.20325203252,627,22950000,36602.87081339713,-12,497000
2017,county,48453,Travis,48085,Collin,TX,Dallas-Fort Worth,1056,52531000,49745.26515151515,969,42823000,44192.98245614035,87,9708000
2017,county,48209,Hays,48085,Collin,TX,Dallas-Fort Worth,174,7159000,41143.67816091954,143,4717000,32986.01398601398,31,2442000
2017,county,48091,Comal,48085,Collin,TX,Dallas-Fort Worth,169,6483000,38360.94674556213,75,2767000,36893.333333333336,94,3716000
2017,county,48029,Bexar,48085,Collin,TX,Dallas-Fort Worth,629,22568000,35879.17329093799,1096,39294000,35852.189781021894,-467,-16726000
2017,county,48029,Bexar,13073,Columbia,GA,Augusta,220,5616000,25527.272727272728,205,6522000,31814.634146341465,15,-906000
2017,county,48491,Williamson,48091,Comal,TX,San Antonio,166,7286000,43891.56626506024,295,11399000,38640.67796610169,-129,-4113000
2017,county,48453,Travis,48091,Comal,TX,San Antonio,391,14345000,36687.97953964194,655,26875000,41030.53435114504,-264,-12530000
2017,county,48209,Hays,48091,Comal,TX,San Antonio,525,15224000,28998.095238095237,1127,47905000,42506.65483584738,-602,-32681000
2017,county,48029,Bexar,48091,Comal,TX,San Antonio,2261,78996000,34938.52277753207,5185,195792000,37761.234329797495,-2924,-116796000
2017,county,48029,Bexar,40031,Comanche,OK,Rural Oklahoma,206,3794000,18417.47572815534,123,2852000,23186.9918699187,83,942000
2017,county,48491,Williamson,06013,Contra Costa,CA,Bay Area,139,5993000,43115.10791366907,50,2080000,41600.0,89,3913000
2017,county,48453,Travis,06013,Contra Costa,CA,Bay Area,352,20886000,59335.22727272727,161,8571000,53236.024844720494,191,12315000
2017,county,48029,Bexar,06013,Contra Costa,CA,Bay Area,139,6157000,44294.96402877698,88,4175000,47443.181818181816,51,1982000
2017,county,48491,Williamson,17031,Cook,IL,Chicago,336,13582000,40422.619047619046,138,11419000,82746.37681159421,198,2163000
2017,county,48453,Travis,17031,Cook,IL,Chicago,1475,96071000,65132.8813559322,1030,37584000,36489.320388349515,445,58487000
2017,county,48209,Hays,17031,Cook,IL,Chicago,71,2437000,34323.94366197183,39,1315000,33717.94871794872,32,1122000
2017,county,48029,Bexar,17031,Cook,IL,Chicago,761,22758000,29905.3876478318,342,11005000,32178.362573099414,419,11753000
2017,county,48491,Williamson,48099,Coryell,TX,Rural Texas,151,4289000,28403.973509933774,226,4432000,19610.619469026547,-75,-143000
2017,county,48453,Travis,48099,Coryell,TX,Rural Texas,140,3004000,21457.14285714286,213,2994000,14056.338028169013,-73,10000
2017,county,48029,Bexar,48099,Coryell,TX,Rural Texas,339,4977000,14681.41592920354,182,3273000,17983.516483516483,157,1704000
2017,county,48029,Bexar,37049,Craven,NC,Rural North Carolina,72,1396000,19388.88888888889,49,1034000,21102.04081632653,23,362000
2017,county,48453,Travis,37051,Cumberland,NC,Rural North Carolina,90,1386000,15400.0,54,1076000,19925.925925925927,36,310000
2017,county,48453,Travis,23005,Cumberland,ME,Portland,33,1432000,43393.93939393939,50,1839000,36780.0,-17,-407000
2017,county,48029,Bexar,37051,Cumberland,NC,Rural North Carolina,443,9484000,21408.57787810384,319,6986000,21899.686520376177,124,2498000
2017,county,48029,Bexar,35009,Curry,NM,Rural New Mexico,145,3156000,21765.51724137931,70,1598000,22828.571428571428,75,1558000
2017,county,48453,Travis,39035,Cuyahoga,OH,Cleveland,202,6291000,31143.564356435643,202,5114000,25316.831683168315,0,1177000
2017,county,48029,Bexar,39035,Cuyahoga,OH,Cleveland,105,3336000,31771.428571428572,84,2985000,35535.71428571428,21,351000
2017,county,48029,Bexar,27037,Dakota,MN,Minneapolis,60,1765000,29416.666666666668,51,1009000,19784.313725490196,9,756000
2017,county,48491,Williamson,48113,Dallas,TX,Dallas-Fort Worth,716,28671000,40043.296089385476,588,25918000,44078.231292517004,128,2753000
2017,county,48453,Travis,48113,Dallas,TX,Dallas-Fort Worth,2513,129284000,51446.080382013526,2473,118388000,47872.21997573797,40,10896000
2017,county,48209,Hays,48113,Dallas,TX,Dallas-Fort Worth,247,8215000,33259.10931174089,196,4994000,25479.591836734693,51,3221000
2017,county,48091,Comal,48113,Dallas,TX,Dallas-Fort Worth,157,6915000,44044.58598726115,111,5405000,48693.69369369369,46,1510000
2017,county,48029,Bexar,48113,Dallas,TX,Dallas-Fort Worth,1610,57843000,35927.32919254658,1861,73002000,39227.29715206878,-251,-15159000
2017,county,48453,Travis,55025,Dane,WI,Madison,198,10749000,54287.878787878784,140,4424000,31600.0,58,6325000
2017,county,48029,Bexar,55025,Dane,WI,Madison,82,3679000,44865.85365853659,54,1613000,29870.37037037037,28,2066000
2017,county,48491,Williamson,47037,Davidson,TN,Nashville,49,1759000,35897.95918367347,33,1121000,33969.69696969697,16,638000
2017,county,48453,Travis,47037,Davidson,TN,Nashville,174,6456000,37103.44827586207,271,11793000,43516.60516605166,-97,-5337000
2017,county,48029,Bexar,47037,Davidson,TN,Nashville,135,4893000,36244.444444444445,132,4471000,33871.21212121212,3,422000
2017,county,48453,Travis,49011,Davis,UT,Rural Utah,58,1468000,25310.344827586207,48,1377000,28687.5,10,91000
2017,county,48029,Bexar,49011,Davis,UT,Rural Utah,143,3946000,27594.405594405594,114,3452000,30280.701754385966,29,494000
2017,county,48453,Travis,13089,DeKalb,GA,Atlanta,176,5560000,31590.909090909092,332,9450000,28463.85542168675,-156,-3890000
2017,county,48029,Bexar,13089,DeKalb,GA,Atlanta,88,2318000,26340.909090909092,130,6044000,46492.307692307695,-42,-3726000
2017,county,48029,Bexar,48123,DeWitt,TX,Rural Texas,68,826000,12147.058823529413,63,914000,14507.936507936507,5,-88000
2017,county,48453,Travis,42045,Delaware,PA,Philadelphia,68,3254000,47852.94117647059,56,948000,16928.571428571428,12,2306000
2017,county,48491,Williamson,48121,Denton,TX,Dallas-Fort Worth,550,19590000,35618.181818181816,433,14336000,33108.54503464203,117,5254000
2017,county,48453,Travis,48121,Denton,TX,Dallas-Fort Worth,796,29941000,37614.3216080402,738,29966000,40604.33604336043,58,-25000
2017,county,48209,Hays,48121,Denton,TX,Dallas-Fort Worth,147,4656000,31673.469387755104,119,3809000,32008.40336134454,28,847000
2017,county,48091,Comal,48121,Denton,TX,Dallas-Fort Worth,114,5407000,47429.82456140351,69,3753000,54391.30434782609,45,1654000
2017,county,48029,Bexar,48121,Denton,TX,Dallas-Fort Worth,679,22962000,33817.378497790865,789,26793000,33958.17490494296,-110,-3831000
2017,county,48491,Williamson,08031,Denver,CO,Denver,64,2262000,35343.75,84,3641000,43345.23809523809,-20,-1379000
2017,county,48453,Travis,08031,Denver,CO,Denver,307,19005000,61905.53745928339,551,31803000,57718.69328493648,-244,-12798000
2017,county,48029,Bexar,08031,Denver,CO,Denver,236,6946000,29432.20338983051,257,13346000,51929.961089494165,-21,-6400000
2017,county,48453,Travis,41017,Deschutes,OR,Rural Oregon,39,2198000,56358.97435897436,66,3646000,55242.42424242424,-27,-1448000
2017,county,48029,Bexar,48127,Dimmit,TX,Rural Texas,133,3264000,24541.353383458645,60,1211000,20183.333333333332,73,2053000
2017,county,48453,Travis,11001,District of Columbia,DC,D.C.,358,21766000,60798.882681564246,258,13288000,51503.875968992244,100,8478000
2017,county,48029,Bexar,11001,District of Columbia,DC,D.C.,117,7001000,59837.606837606836,127,6094000,47984.25196850394,-10,907000
2017,county,48453,Travis,35013,Dona Ana,NM,Rural New Mexico,54,1333000,24685.185185185186,66,2415000,36590.90909090909,-12,-1082000
2017,county,48029,Bexar,35013,Dona Ana,NM,Rural New Mexico,162,4596000,28370.37037037037,99,2149000,21707.070707070707,63,2447000
2017,county,48491,Williamson,08035,Douglas,CO,Denver,98,5092000,51959.183673469386,84,5131000,61083.333333333336,14,-39000
2017,county,48453,Travis,08035,Douglas,CO,Denver,130,7963000,61253.846153846156,184,12400000,67391.30434782608,-54,-4437000
2017,county,48453,Travis,31055,Douglas,NE,Omaha,97,4512000,46515.463917525776,75,2816000,37546.666666666664,22,1696000
2017,county,48029,Bexar,31055,Douglas,NE,Omaha,119,4096000,34420.16806722689,112,3680000,32857.142857142855,7,416000
2017,county,48029,Bexar,08035,Douglas,CO,Denver,105,4466000,42533.333333333336,168,6789000,40410.71428571428,-63,-2323000
2017,county,48453,Travis,17043,DuPage,IL,Chicago,208,17231000,82841.34615384616,128,4799000,37492.1875,80,12432000
2017,county,48029,Bexar,17043,DuPage,IL,Chicago,196,11630000,59336.73469387755,85,3207000,37729.41176470588,111,8423000
2017,county,48453,Travis,37063,Durham,NC,Raleigh,123,5477000,44528.455284552845,119,5156000,43327.731092436974,4,321000
2017,county,48453,Travis,12031,Duval,FL,Jacksonville,201,4357000,21676.616915422885,255,5204000,20407.843137254902,-54,-847000
2017,county,48029,Bexar,12031,Duval,FL,Jacksonville,251,5962000,23752.988047808765,198,5003000,25267.676767676767,53,959000
2017,county,48453,Travis,22033,East Baton Rouge Parish,LA,Rural Louisiana,195,6471000,33184.61538461538,124,3417000,27556.451612903227,71,3054000
2017,county,48029,Bexar,22033,East Baton Rouge Parish,LA,Rural Louisiana,115,2902000,25234.782608695652,109,2357000,21623.853211009173,6,545000
2017,county,48491,Williamson,48135,Ector,TX,Rural Texas,104,3354000,32250.0,41,990000,24146.341463414636,63,2364000
2017,county,48453,Travis,48135,Ector,TX,Rural Texas,156,4404000,28230.76923076923,69,1686000,24434.782608695652,87,2718000
2017,county,48029,Bexar,48135,Ector,TX,Rural Texas,348,6474000,18603.44827586207,201,3530000,17562.18905472637,147,2944000
2017,county,48491,Williamson,48141,El Paso,TX,El Paso,312,8320000,26666.666666666668,166,5203000,31343.373493975905,146,3117000
2017,county,48491,Williamson,08041,El Paso,CO,Colorado Springs,148,4197000,28358.108108108107,177,6133000,34649.71751412429,-29,-1936000
2017,county,48453,Travis,48141,El Paso,TX,El Paso,697,24937000,35777.61836441894,414,10222000,24690.82125603865,283,14715000
2017,county,48453,Travis,08041,El Paso,CO,Colorado Springs,217,7512000,34617.511520737324,289,12123000,41948.096885813145,-72,-4611000
2017,county,48209,Hays,48141,El Paso,TX,El Paso,119,2921000,24546.21848739496,53,1088000,20528.30188679245,66,1833000
2017,county,48029,Bexar,48141,El Paso,TX,El Paso,2170,48325000,22269.585253456222,1178,33315000,28280.984719864176,992,15010000
2017,county,48029,Bexar,08041,El Paso,CO,Colorado Springs,1229,26528000,21585.028478437755,1137,29513000,25956.904133685137,92,-2985000
2017,county,48491,Williamson,48139,Ellis,TX,Dallas-Fort Worth,73,1963000,26890.41095890411,54,1802000,33370.37037037037,19,161000
2017,county,48453,Travis,48139,Ellis,TX,Dallas-Fort Worth,77,2276000,29558.44155844156,122,3448000,28262.29508196721,-45,-1172000
2017,county,48029,Bexar,48139,Ellis,TX,Dallas-Fort Worth,62,1720000,27741.935483870966,116,3340000,28793.103448275862,-54,-1620000
2017,county,48453,Travis,48143,Erath,TX,Rural Texas,21,478000,22761.904761904763,32,590000,18437.5,-11,-112000
2017,county,48453,Travis,36029,Erie,NY,Buffalo,69,3457000,50101.44927536232,86,2259000,26267.441860465115,-17,1198000
2017,county,48029,Bexar,36029,Erie,NY,Buffalo,72,2170000,30138.88888888889,73,1739000,23821.91780821918,-1,431000
2017,county,48453,Travis,12033,Escambia,FL,FL Panhandle,83,1951000,23506.024096385543,81,1597000,19716.04938271605,2,354000
2017,county,48029,Bexar,12033,Escambia,FL,FL Panhandle,214,4387000,20500.0,144,4112000,28555.555555555555,70,275000
2017,county,48453,Travis,34013,Essex,NJ,New York,101,4419000,43752.47524752475,68,1980000,29117.647058823528,33,2439000
2017,county,48453,Travis,25009,Essex,MA,Boston,79,5207000,65911.39240506329,98,5531000,56438.77551020408,-19,-324000
2017,county,48029,Bexar,02090,Fairbanks North Star Borough,AK,Rural Alaska,152,3465000,22796.052631578947,127,2694000,21212.59842519685,25,771000
2017,county,48491,Williamson,51059,Fairfax,VA,D.C.,136,6027000,44316.17647058824,63,2553000,40523.80952380953,73,3474000
2017,county,48453,Travis,51059,Fairfax,VA,D.C.,332,19156000,57698.79518072289,224,9294000,41491.07142857143,108,9862000
2017,county,48029,Bexar,51059,Fairfax,VA,D.C.,667,25156000,37715.142428785606,669,23497000,35122.57100149477,-2,1659000
2017,county,48453,Travis,09001,Fairfield,CT,New York,250,18821000,75284.0,103,11071000,107485.43689320388,147,7750000
2017,county,48029,Bexar,09001,Fairfield,CT,New York,68,4196000,61705.882352941175,60,1484000,24733.333333333332,8,2712000
2017,county,48453,Travis,21067,Fayette,KY,Lexington,81,3285000,40555.555555555555,71,2176000,30647.88732394366,10,1109000
2017,county,48453,Travis,48149,Fayette,TX,Rural Texas,85,1974000,23223.529411764706,92,4498000,48891.30434782609,-7,-2524000
2017,county,48453,Travis,37067,Forsyth,NC,Greensboro,51,1336000,26196.07843137255,80,2071000,25887.5,-29,-735000
2017,county,48029,Bexar,37067,Forsyth,NC,Greensboro,87,2278000,26183.908045977012,83,2911000,35072.2891566265,4,-633000
2017,county,48491,Williamson,48157,Fort Bend,TX,Houston,404,17455000,43205.44554455446,261,9126000,34965.51724137931,143,8329000
2017,county,48453,Travis,48157,Fort Bend,TX,Houston,859,48310000,56239.81373690338,600,23765000,39608.333333333336,259,24545000
2017,county,48209,Hays,48157,Fort Bend,TX,Houston,241,11192000,46439.83402489626,110,2618000,23800.0,131,8574000
2017,county,48091,Comal,48157,Fort Bend,TX,Houston,226,14423000,63818.58407079646,54,2021000,37425.92592592593,172,12402000
2017,county,48029,Bexar,48157,Fort Bend,TX,Houston,685,25519000,37254.01459854015,658,21714000,33000.0,27,3805000
2017,county,48491,Williamson,39049,Franklin,OH,Columbus,74,3233000,43689.18918918919,69,2164000,31362.318840579712,5,1069000
2017,county,48453,Travis,39049,Franklin,OH,Columbus,299,12609000,42170.56856187291,166,5189000,31259.036144578313,133,7420000
2017,county,48029,Bexar,39049,Franklin,OH,Columbus,186,7070000,38010.75268817204,309,8148000,26368.93203883495,-123,-1078000
2017,county,48029,Bexar,24021,Frederick,MD,Rural Maryland,85,2889000,33988.23529411765,121,2979000,24619.834710743802,-36,-90000
2017,county,48453,Travis,06019,Fresno,CA,Fresno,99,1540000,15555.555555555555,97,1218000,12556.701030927836,2,322000
2017,county,48029,Bexar,06019,Fresno,CA,Fresno,53,1393000,26283.01886792453,84,1834000,21833.333333333332,-31,-441000
2017,county,48029,Bexar,48163,Frio,TX,Rural Texas,212,3890000,18349.056603773584,192,4231000,22036.458333333332,20,-341000
2017,county,48491,Williamson,13121,Fulton,GA,Atlanta,61,2477000,40606.55737704918,68,3108000,45705.882352941175,-7,-631000
2017,county,48453,Travis,13121,Fulton,GA,Atlanta,368,18022000,48972.82608695652,494,18578000,37607.287449392716,-126,-556000
2017,county,48029,Bexar,13121,Fulton,GA,Atlanta,154,5383000,34954.545454545456,172,9637000,56029.06976744186,-18,-4254000
2017,county,48491,Williamson,48167,Galveston,TX,Houston,186,7916000,42559.13978494624,151,4748000,31443.70860927152,35,3168000
2017,county,48453,Travis,48167,Galveston,TX,Houston,317,14416000,45476.34069400631,290,10001000,34486.206896551725,27,4415000
2017,county,48209,Hays,48167,Galveston,TX,Houston,85,2745000,32294.117647058825,66,2114000,32030.303030303032,19,631000
2017,county,48029,Bexar,48167,Galveston,TX,Houston,258,7863000,30476.74418604651,328,10381000,31649.39024390244,-70,-2518000
2017,county,48029,Bexar,20061,Geary,KS,Rural Kansas,215,3280000,15255.813953488372,72,1240000,17222.222222222223,143,2040000
2017,county,48029,Bexar,26049,Genesee,MI,Rural Michigan,53,1003000,18924.528301886792,37,766000,20702.702702702703,16,237000
2017,county,48491,Williamson,48171,Gillespie,TX,Rural Texas,33,1086000,32909.09090909091,49,1511000,30836.73469387755,-16,-425000
2017,county,48453,Travis,48171,Gillespie,TX,Rural Texas,88,2255000,25625.0,127,8903000,70102.36220472441,-39,-6648000
2017,county,48029,Bexar,48171,Gillespie,TX,Rural Texas,119,4817000,40478.991596638654,171,5906000,34538.01169590643,-52,-1089000
2017,county,48453,Travis,48177,Gonzales,TX,Rural Texas,31,1763000,56870.967741935485,43,950000,22093.023255813954,-12,813000
2017,county,48209,Hays,48177,Gonzales,TX,Rural Texas,49,919000,18755.102040816328,44,1416000,32181.81818181818,5,-497000
2017,county,48029,Bexar,48177,Gonzales,TX,Rural Texas,86,1282000,14906.976744186046,58,1407000,24258.620689655174,28,-125000
2017,county,48453,Travis,48181,Grayson,TX,Rural Texas,41,1199000,29243.90243902439,50,2146000,42920.0,-9,-947000
2017,county,48029,Bexar,39057,Greene,OH,Rural Ohio,171,5582000,32643.27485380117,164,4879000,29750.0,7,703000
2017,county,48029,Bexar,29077,Greene,MO,Rural Missouri,57,1218000,21368.42105263158,40,1034000,25850.0,17,184000
2017,county,48453,Travis,45045,Greenville,SC,Greenville,51,1120000,21960.78431372549,81,3164000,39061.72839506173,-30,-2044000
2017,county,48029,Bexar,45045,Greenville,SC,Greenville,47,1315000,27978.72340425532,60,2083000,34716.666666666664,-13,-768000
2017,county,48453,Travis,48183,Gregg,TX,Rural Texas,86,2965000,34476.74418604651,77,2242000,29116.883116883117,9,723000
2017,county,48029,Bexar,48183,Gregg,TX,Rural Texas,78,2231000,28602.5641025641,70,1844000,26342.85714285714,8,387000
2017,county,48491,Williamson,48187,Guadalupe,TX,San Antonio,152,4101000,26980.263157894737,154,5753000,37357.142857142855,-2,-1652000
2017,county,48453,Travis,48187,Guadalupe,TX,San Antonio,255,8048000,31560.78431372549,439,12514000,28505.694760820046,-184,-4466000
2017,county,48209,Hays,48187,Guadalupe,TX,San Antonio,736,13579000,18449.728260869564,1019,26130000,25642.78704612365,-283,-12551000
2017,county,48091,Comal,48187,Guadalupe,TX,San Antonio,3331,114019000,34229.66076253377,2641,71113000,26926.5429761454,690,42906000
2017,county,48029,Bexar,48187,Guadalupe,TX,San Antonio,3878,100214000,25841.670964414647,6937,185907000,26799.336889145165,-3059,-85693000
2017,county,48453,Travis,37081,Guilford,NC,Greensboro,81,3667000,45271.60493827161,80,1836000,22950.0,1,1831000
2017,county,48029,Bexar,37081,Guilford,NC,Greensboro,45,1021000,22688.88888888889,68,1525000,22426.470588235294,-23,-504000
2017,county,48453,Travis,13135,Gwinnett,GA,Atlanta,154,3591000,23318.18181818182,169,3486000,20627.21893491124,-15,105000
2017,county,48029,Bexar,13135,Gwinnett,GA,Atlanta,126,2977000,23626.984126984127,105,2609000,24847.619047619046,21,368000
2017,county,48029,Bexar,48189,Hale,TX,Rural Texas,45,649000,14422.222222222223,42,654000,15571.42857142857,3,-5000
2017,county,48453,Travis,39061,Hamilton,OH,Cincinnati,144,9267000,64354.166666666664,115,3075000,26739.130434782608,29,6192000
2017,county,48453,Travis,18057,Hamilton,IN,Indianapolis,61,3671000,60180.32786885246,51,2247000,44058.82352941176,10,1424000
2017,county,48453,Travis,47065,Hamilton,TN,Chattanooga,36,1073000,29805.555555555555,70,2573000,36757.142857142855,-34,-1500000
2017,county,48029,Bexar,39061,Hamilton,OH,Cincinnati,69,2965000,42971.014492753624,97,3975000,40979.38144329897,-28,-1010000
2017,county,48029,Bexar,18057,Hamilton,IN,Indianapolis,91,3511000,38582.41758241758,50,1696000,33920.0,41,1815000
2017,county,48029,Bexar,51650,Hampton city,VA,Hampton Roads,128,3640000,28437.5,83,1739000,20951.807228915663,45,1901000
2017,county,48029,Bexar,21093,Hardin,KY,Louisville,112,3140000,28035.714285714286,99,2630000,26565.656565656565,13,510000
2017,county,48029,Bexar,24025,Harford,MD,Baltimore,50,1330000,26600.0,56,1518000,27107.14285714286,-6,-188000
2017,county,48029,Bexar,37085,Harnett,NC,Rural North Carolina,140,3282000,23442.85714285714,153,2615000,17091.503267973858,-13,667000
2017,county,48491,Williamson,48201,Harris,TX,Houston,1807,77930000,43126.72938572219,1160,28364000,24451.724137931036,647,49566000
2017,county,48453,Travis,48201,Harris,TX,Houston,5294,275251000,51993.010955799014,3696,136111000,36826.569264069265,1598,139140000
2017,county,48209,Hays,48201,Harris,TX,Houston,782,32209000,41187.97953964194,540,14276000,26437.037037037036,242,17933000
2017,county,48091,Comal,48201,Harris,TX,Houston,953,56351000,59130.11542497377,271,10344000,38169.741697416976,682,46007000
2017,county,48029,Bexar,48201,Harris,TX,Houston,4153,132910000,32003.37105706718,3466,117988000,34041.546451240625,687,14922000
2017,county,48453,Travis,28047,Harrison,MS,Gulfport-Biloxi,33,587000,17787.878787878788,75,1357000,18093.333333333332,-42,-770000
2017,county,48029,Bexar,28047,Harrison,MS,Gulfport-Biloxi,291,6725000,23109.96563573883,188,4550000,24202.127659574468,103,2175000
2017,county,48029,Bexar,48203,Harrison,TX,Rural Texas,40,1220000,30500.0,46,1190000,25869.565217391304,-6,30000
2017,county,48453,Travis,09003,Hartford,CT,Hartford,133,5635000,42368.42105263158,79,2724000,34481.012658227846,54,2911000
2017,county,48029,Bexar,09003,Hartford,CT,Hartford,72,4365000,60625.0,59,2368000,40135.59322033898,13,1997000
2017,county,48453,Travis,15001,Hawaii,HI,Rural Hawaii,41,1831000,44658.53658536585,38,1172000,30842.105263157893,3,659000
2017,county,48491,Williamson,48209,Hays,TX,Austin,909,28820000,31705.170517051705,956,30810000,32228.03347280335,-47,-1990000
2017,county,48453,Travis,48209,Hays,TX,Austin,4463,150316000,33680.48397938607,10133,351060000,34645.21859271687,-5670,-200744000
2017,county,48091,Comal,48209,Hays,TX,Austin,1127,47905000,42506.65483584738,525,15224000,28998.095238095237,602,32681000
2017,county,48029,Bexar,48209,Hays,TX,Austin,929,22069000,23755.651237890204,925,25094000,27128.64864864865,4,-3025000
2017,county,48029,Bexar,48213,Henderson,TX,Rural Texas,35,632000,18057.14285714286,62,1687000,27209.677419354837,-27,-1055000
2017,county,48491,Williamson,27053,Hennepin,MN,Minneapolis,96,5222000,54395.833333333336,39,1664000,42666.666666666664,57,3558000
2017,county,48453,Travis,27053,Hennepin,MN,Minneapolis,272,19548000,71867.64705882352,243,11856000,48790.12345679013,29,7692000
2017,county,48029,Bexar,27053,Hennepin,MN,Minneapolis,156,7688000,49282.05128205128,137,6744000,49226.277372262775,19,944000
2017,county,48453,Travis,51087,Henrico,VA,Richmond,72,2489000,34569.444444444445,60,2508000,41800.0,12,-19000
2017,county,48029,Bexar,51087,Henrico,VA,Richmond,39,1639000,42025.64102564102,52,1730000,33269.230769230766,-13,-91000
2017,county,48491,Williamson,48215,Hidalgo,TX,Rural Texas,240,7044000,29350.0,106,2150000,20283.01886792453,134,4894000
2017,county,48453,Travis,48215,Hidalgo,TX,Rural Texas,645,21133000,32764.341085271317,422,9061000,21471.563981042655,223,12072000
2017,county,48209,Hays,48215,Hidalgo,TX,Rural Texas,126,3600000,28571.428571428572,71,1964000,27661.971830985916,55,1636000
2017,county,48091,Comal,48215,Hidalgo,TX,Rural Texas,95,3480000,36631.57894736842,40,661000,16525.0,55,2819000
2017,county,48029,Bexar,48215,Hidalgo,TX,Rural Texas,1716,39800000,23193.473193473194,933,17435000,18687.031082529476,783,22365000
2017,county,48491,Williamson,12057,Hillsborough,FL,Tampa,101,3781000,37435.64356435643,90,3040000,33777.77777777778,11,741000
2017,county,48453,Travis,12057,Hillsborough,FL,Tampa,381,10467000,27472.44094488189,492,18441000,37481.70731707317,-111,-7974000
2017,county,48453,Travis,33011,Hillsborough,NH,Rural New Hampshire,74,4105000,55472.97297297297,63,2357000,37412.69841269841,11,1748000
2017,county,48029,Bexar,12057,Hillsborough,FL,Tampa,414,11371000,27466.183574879225,413,12518000,30309.92736077482,1,-1147000
2017,county,48453,Travis,28049,Hinds,MS,Jackson,94,1799000,19138.297872340427,72,811000,11263.888888888889,22,988000
2017,county,48491,Williamson,15003,Honolulu,HI,Rural Hawaii,172,4989000,29005.81395348837,71,1674000,23577.464788732395,101,3315000
2017,county,48453,Travis,15003,Honolulu,HI,Rural Hawaii,202,6539000,32371.287128712873,114,2756000,24175.43859649123,88,3783000
2017,county,48029,Bexar,15003,Honolulu,HI,Rural Hawaii,1323,32114000,24273.620559334846,710,16858000,23743.661971830985,613,15256000
2017,county,48453,Travis,48221,Hood,TX,Rural Texas,34,916000,26941.176470588234,35,1260000,36000.0,-1,-344000
2017,county,48029,Bexar,48221,Hood,TX,Rural Texas,39,1190000,30512.82051282051,74,2936000,39675.67567567567,-35,-1746000
2017,county,48029,Bexar,13153,Houston,GA,Rural Georgia,162,3977000,24549.382716049382,107,2589000,24196.26168224299,55,1388000
2017,county,48453,Travis,24027,Howard,MD,Baltimore,59,2081000,35271.186440677964,39,1803000,46230.769230769234,20,278000
2017,county,48029,Bexar,24027,Howard,MD,Baltimore,152,7603000,50019.73684210526,71,2956000,41633.80281690141,81,4647000
2017,county,48029,Bexar,48227,Howard,TX,Rural Texas,86,1536000,17860.46511627907,43,1036000,24093.023255813954,43,500000
2017,county,48453,Travis,34017,Hudson,NJ,New York,174,13018000,74816.091954023,132,6271000,47507.57575757576,42,6747000
2017,county,48029,Bexar,34017,Hudson,NJ,New York,112,3795000,33883.92857142857,40,1235000,30875.0,72,2560000
2017,county,48453,Travis,48231,Hunt,TX,Dallas-Fort Worth,48,939000,19562.5,49,1109000,22632.65306122449,-1,-170000
2017,county,48453,Travis,26065,Ingham,MI,Rural Michigan,46,1714000,37260.86956521739,75,2195000,29266.666666666668,-29,-481000
2017,county,48453,Travis,29095,Jackson,MO,Kansas City,121,3902000,32247.93388429752,141,5297000,37567.375886524824,-20,-1395000
2017,county,48029,Bexar,29095,Jackson,MO,Kansas City,102,2032000,19921.56862745098,86,3211000,37337.20930232558,16,-1179000
2017,county,48029,Bexar,28059,Jackson,MS,Gulfport-Biloxi,83,2339000,28180.722891566264,84,2543000,30273.809523809523,-1,-204000
2017,county,48491,Williamson,48245,Jefferson,TX,Rural Texas,130,4716000,36276.92307692308,49,1695000,34591.836734693876,81,3021000
2017,county,48491,Williamson,08059,Jefferson,CO,Denver,88,3174000,36068.181818181816,75,3533000,47106.666666666664,13,-359000
2017,county,48453,Travis,48245,Jefferson,TX,Rural Texas,228,7000000,30701.754385964912,138,2996000,21710.144927536232,90,4004000
2017,county,48453,Travis,08059,Jefferson,CO,Denver,142,7155000,50387.32394366197,240,12015000,50062.5,-98,-4860000
2017,county,48453,Travis,01073,Jefferson,AL,Birmingham,136,5596000,41147.05882352941,88,2227000,25306.81818181818,48,3369000
2017,county,48453,Travis,21111,Jefferson,KY,Louisville,98,5622000,57367.34693877551,107,3417000,31934.579439252335,-9,2205000
2017,county,48029,Bexar,36045,Jefferson,NY,Rural New York,248,4286000,17282.25806451613,141,2287000,16219.85815602837,107,1999000
2017,county,48029,Bexar,48245,Jefferson,TX,Rural Texas,158,4178000,26443.037974683546,120,2638000,21983.333333333332,38,1540000
2017,county,48029,Bexar,08059,Jefferson,CO,Denver,152,4200000,27631.57894736842,110,5619000,51081.818181818184,42,-1419000
2017,county,48029,Bexar,21111,Jefferson,KY,Louisville,100,1894000,18940.0,86,2495000,29011.627906976744,14,-601000
2017,county,48029,Bexar,01073,Jefferson,AL,Birmingham,46,1557000,33847.82608695652,48,1174000,24458.333333333332,-2,383000
2017,county,48453,Travis,22051,Jefferson Parish,LA,New Orleans,148,4613000,31168.91891891892,73,1595000,21849.31506849315,75,3018000
2017,county,48029,Bexar,22051,Jefferson Parish,LA,New Orleans,104,2828000,27192.30769230769,70,1643000,23471.428571428572,34,1185000
2017,county,48029,Bexar,48249,Jim Wells,TX,Rural Texas,285,5657000,19849.122807017542,140,2267000,16192.857142857143,145,3390000
2017,county,48491,Williamson,20091,Johnson,KS,Kansas City,130,5300000,40769.230769230766,57,1536000,26947.36842105263,73,3764000
2017,county,48491,Williamson,48251,Johnson,TX,Dallas-Fort Worth,56,1402000,25035.714285714286,66,1958000,29666.666666666668,-10,-556000
2017,county,48453,Travis,20091,Johnson,KS,Kansas City,147,6805000,46292.51700680272,144,5318000,36930.555555555555,3,1487000
2017,county,48453,Travis,48251,Johnson,TX,Dallas-Fort Worth,56,1706000,30464.285714285714,85,2545000,29941.176470588234,-29,-839000
2017,county,48029,Bexar,20091,Johnson,KS,Kansas City,130,4263000,32792.307692307695,172,6906000,40151.16279069767,-42,-2643000
2017,county,48029,Bexar,48251,Johnson,TX,Dallas-Fort Worth,91,2740000,30109.89010989011,118,3161000,26788.13559322034,-27,-421000
2017,county,48029,Bexar,29101,Johnson,MO,Rural Missouri,89,2324000,26112.3595505618,69,1210000,17536.231884057972,20,1114000
2017,county,48453,Travis,26077,Kalamazoo,MI,Rural Michigan,58,1880000,32413.793103448275,39,742000,19025.641025641027,19,1138000
2017,county,48453,Travis,17089,Kane,IL,Chicago,69,3018000,43739.13043478261,49,1188000,24244.897959183672,20,1830000
2017,county,48029,Bexar,17089,Kane,IL,Chicago,124,3526000,28435.483870967742,42,1142000,27190.47619047619,82,2384000
2017,county,48029,Bexar,48255,Karnes,TX,Rural Texas,127,3306000,26031.496062992126,128,1480000,11562.5,-1,1826000
2017,county,48453,Travis,48257,Kaufman,TX,Dallas-Fort Worth,58,2175000,37500.0,41,1413000,34463.41463414634,17,762000
2017,county,48029,Bexar,48257,Kaufman,TX,Dallas-Fort Worth,69,1554000,22521.739130434784,68,1807000,26573.529411764706,1,-253000
2017,county,48453,Travis,48259,Kendall,TX,Rural Texas,62,5371000,86629.03225806452,91,3814000,41912.08791208791,-29,1557000
2017,county,48091,Comal,48259,Kendall,TX,Rural Texas,183,7920000,43278.688524590165,147,8339000,56727.89115646258,36,-419000
2017,county,48029,Bexar,48259,Kendall,TX,Rural Texas,1245,52429000,42111.646586345385,2742,144529000,52709.33625091174,-1497,-92100000
2017,county,48453,Travis,26081,Kent,MI,Rural Michigan,90,2350000,26111.11111111111,101,3874000,38356.43564356436,-11,-1524000
2017,county,48029,Bexar,10001,Kent,DE,Rural Delaware,109,2848000,26128.440366972478,103,1600000,15533.980582524271,6,1248000
2017,county,48029,Bexar,26081,Kent,MI,Rural Michigan,70,1121000,16014.285714285714,51,1609000,31549.019607843136,19,-488000
2017,county,48453,Travis,06029,Kern,CA,Rural California,306,4800000,15686.274509803921,72,1132000,15722.222222222223,234,3668000
2017,county,48029,Bexar,06029,Kern,CA,Rural California,147,2365000,16088.43537414966,127,2718000,21401.574803149608,20,-353000
2017,county,48491,Williamson,48265,Kerr,TX,Rural Texas,59,1943000,32932.20338983051,74,2275000,30743.243243243243,-15,-332000
2017,county,48453,Travis,48265,Kerr,TX,Rural Texas,111,3008000,27099.099099099098,138,5248000,38028.985507246376,-27,-2240000
2017,county,48209,Hays,48265,Kerr,TX,Rural Texas,43,892000,20744.18604651163,43,1569000,36488.37209302326,0,-677000
2017,county,48091,Comal,48265,Kerr,TX,Rural Texas,50,1265000,25300.0,47,1615000,34361.70212765958,3,-350000
2017,county,48029,Bexar,48265,Kerr,TX,Rural Texas,371,10602000,28576.819407008086,443,14976000,33805.8690744921,-72,-4374000
2017,county,48491,Williamson,53033,King,WA,Seattle,396,19721000,49800.50505050505,256,12172000,47546.875,140,7549000
2017,county,48453,Travis,53033,King,WA,Seattle,785,49826000,63472.611464968155,1123,70400000,62689.22528940338,-338,-20574000
2017,county,48209,Hays,53033,King,WA,Seattle,64,3217000,50265.625,43,1196000,27813.95348837209,21,2021000
2017,county,48029,Bexar,53033,King,WA,Seattle,296,14082000,47574.32432432433,399,17914000,44897.24310776942,-103,-3832000
2017,county,48491,Williamson,36047,Kings,NY,New York,50,1923000,38460.0,35,1096000,31314.285714285714,15,827000
2017,county,48453,Travis,36047,Kings,NY,New York,637,39148000,61456.82888540031,440,16718000,37995.454545454544,197,22430000
2017,county,48029,Bexar,36047,Kings,NY,New York,184,5435000,29538.043478260868,97,3176000,32742.268041237112,87,2259000
2017,county,48453,Travis,53035,Kitsap,WA,Rural Washington,47,1324000,28170.212765957447,57,2368000,41543.85964912281,-10,-1044000
2017,county,48029,Bexar,53035,Kitsap,WA,Rural Washington,147,3940000,26802.721088435374,99,2996000,30262.62626262626,48,944000
2017,county,48029,Bexar,48273,Kleberg,TX,Rural Texas,169,4073000,24100.59171597633,65,1115000,17153.846153846152,104,2958000
2017,county,48453,Travis,47093,Knox,TN,Knoxville,104,3678000,35365.38461538462,83,4049000,48783.132530120485,21,-371000
2017,county,48029,Bexar,47093,Knox,TN,Knoxville,49,1480000,30204.081632653062,60,2070000,34500.0,-11,-590000
2017,county,48029,Bexar,48283,La Salle,TX,Rural Texas,71,1217000,17140.845070422536,30,724000,24133.333333333332,41,493000
2017,county,48453,Travis,22055,Lafayette Parish,LA,Rural Louisiana,105,2710000,25809.52380952381,72,1840000,25555.555555555555,33,870000
2017,county,48029,Bexar,22055,Lafayette Parish,LA,Rural Louisiana,71,1580000,22253.521126760563,37,1068000,28864.864864864863,34,512000
2017,county,48453,Travis,17097,Lake,IL,Chicago,192,10445000,54401.041666666664,92,3179000,34554.34782608696,100,7266000
2017,county,48453,Travis,12069,Lake,FL,Orlando,33,642000,19454.545454545456,47,1560000,33191.48936170213,-14,-918000
2017,county,48029,Bexar,17097,Lake,IL,Chicago,145,4125000,28448.275862068964,78,1411000,18089.74358974359,67,2714000
2017,county,48029,Bexar,18089,Lake,IN,Rural Indiana,76,2324000,30578.947368421053,40,915000,22875.0,36,1409000
2017,county,48491,Williamson,48281,Lampasas,TX,Rural Texas,104,2770000,26634.615384615383,175,5721000,32691.428571428572,-71,-2951000
2017,county,48453,Travis,48281,Lampasas,TX,Rural Texas,43,1095000,25465.116279069767,131,4180000,31908.396946564884,-88,-3085000
2017,county,48453,Travis,31109,Lancaster,NE,Rural Nebraska,46,1927000,41891.30434782609,74,1500000,20270.27027027027,-28,427000
2017,county,48453,Travis,42071,Lancaster,PA,Rural Pennsylvania,47,1273000,27085.106382978724,40,1343000,33575.0,7,-70000
2017,county,48029,Bexar,31109,Lancaster,NE,Rural Nebraska,53,1413000,26660.377358490565,45,1489000,33088.88888888889,8,-76000
2017,county,48453,Travis,41039,Lane,OR,Rural Oregon,53,1605000,30283.01886792453,101,2576000,25504.950495049507,-48,-971000
2017,county,48029,Bexar,56021,Laramie,WY,Rural Wyoming,85,1696000,19952.941176470587,84,1536000,18285.714285714286,1,160000
2017,county,48491,Williamson,08069,Larimer,CO,Rural Colorado,58,2112000,36413.793103448275,78,2891000,37064.10256410256,-20,-779000
2017,county,48453,Travis,08069,Larimer,CO,Rural Colorado,90,4398000,48866.666666666664,172,10353000,60191.86046511628,-82,-5955000
2017,county,48029,Bexar,08069,Larimer,CO,Rural Colorado,72,2786000,38694.444444444445,89,2724000,30606.74157303371,-17,62000
2017,county,48029,Bexar,20103,Leavenworth,KS,Kansas City,98,2277000,23234.69387755102,91,2474000,27186.813186813186,7,-197000
2017,county,48491,Williamson,48287,Lee,TX,Rural Texas,59,1358000,23016.949152542373,103,2945000,28592.233009708736,-44,-1587000
2017,county,48491,Williamson,12071,Lee,FL,S.W. Florida,51,1508000,29568.62745098039,40,1480000,37000.0,11,28000
2017,county,48453,Travis,12071,Lee,FL,S.W. Florida,152,3790000,24934.21052631579,138,2992000,21681.159420289856,14,798000
2017,county,48453,Travis,48287,Lee,TX,Rural Texas,77,1550000,20129.87012987013,224,5071000,22638.39285714286,-147,-3521000
2017,county,48029,Bexar,12071,Lee,FL,S.W. Florida,112,2526000,22553.571428571428,53,1773000,33452.83018867925,59,753000
2017,county,48453,Travis,12073,Leon,FL,Rural Florida,106,2530000,23867.924528301886,73,1617000,22150.68493150685,33,913000
2017,county,48029,Bexar,13179,Liberty,GA,Rural Georgia,177,2498000,14112.994350282486,77,1799000,23363.636363636364,100,699000
2017,county,48029,Bexar,48297,Live Oak,TX,Rural Texas,66,1377000,20863.636363636364,59,1452000,24610.169491525423,7,-75000
2017,county,48491,Williamson,48299,Llano,TX,Rural Texas,96,3883000,40447.916666666664,161,7591000,47149.068322981366,-65,-3708000
2017,county,48453,Travis,48299,Llano,TX,Rural Texas,86,2863000,33290.6976744186,223,11560000,51838.56502242153,-137,-8697000
2017,county,48029,Bexar,48299,Llano,TX,Rural Texas,45,1347000,29933.333333333332,89,5044000,56674.15730337079,-44,-3697000
2017,county,48491,Williamson,06037,Los Angeles,CA,Los Angeles,670,23597000,35219.40298507463,215,7550000,35116.27906976744,455,16047000
2017,county,48453,Travis,06037,Los Angeles,CA,Los Angeles,2162,113311000,52410.26827012026,1567,74013000,47232.291001914484,595,39298000
2017,county,48209,Hays,06037,Los Angeles,CA,Los Angeles,123,4735000,38495.93495934959,77,1730000,22467.532467532466,46,3005000
2017,county,48091,Comal,06037,Los Angeles,CA,Los Angeles,69,3219000,46652.17391304348,48,1666000,34708.333333333336,21,1553000
2017,county,48029,Bexar,06037,Los Angeles,CA,Los Angeles,1454,41082000,28254.470426409905,793,22699000,28624.21185372005,661,18383000
2017,county,48453,Travis,51107,Loudoun,VA,Rural Virginia,119,6500000,54621.8487394958,68,3213000,47250.0,51,3287000
2017,county,48029,Bexar,51107,Loudoun,VA,Rural Virginia,103,5410000,52524.271844660194,76,2937000,38644.73684210526,27,2473000
2017,county,48029,Bexar,13185,Lowndes,GA,Rural Georgia,124,2210000,17822.58064516129,79,1652000,20911.392405063292,45,558000
2017,county,48491,Williamson,48303,Lubbock,TX,Rural Texas,274,7757000,28310.218978102188,156,3623000,23224.358974358973,118,4134000
2017,county,48453,Travis,48303,Lubbock,TX,Rural Texas,396,12751000,32199.49494949495,270,7520000,27851.85185185185,126,5231000
2017,county,48209,Hays,48303,Lubbock,TX,Rural Texas,117,3595000,30726.495726495727,65,1588000,24430.76923076923,52,2007000
2017,county,48091,Comal,48303,Lubbock,TX,Rural Texas,67,3141000,46880.59701492537,36,960000,26666.666666666668,31,2181000
2017,county,48029,Bexar,48303,Lubbock,TX,Rural Texas,441,12018000,27251.700680272108,281,5346000,19024.91103202847,160,6672000
2017,county,48453,Travis,26099,Macomb,MI,Rural Michigan,76,2871000,37776.31578947369,84,1850000,22023.809523809523,-8,1021000
2017,county,48029,Bexar,26099,Macomb,MI,Rural Michigan,59,1384000,23457.627118644068,34,908000,26705.882352941175,25,476000
2017,county,48453,Travis,01089,Madison,AL,Huntsville,46,1919000,41717.391304347824,76,1537000,20223.684210526317,-30,382000
2017,county,48029,Bexar,01089,Madison,AL,Huntsville,85,1900000,22352.941176470587,121,4122000,34066.115702479336,-36,-2222000
2017,county,48453,Travis,12081,Manatee,FL,Rural Florida,75,1400000,18666.666666666668,89,2715000,30505.61797752809,-14,-1315000
2017,county,48029,Bexar,12081,Manatee,FL,Rural Florida,53,1536000,28981.132075471698,43,3030000,70465.11627906977,10,-1494000
2017,county,48491,Williamson,04013,Maricopa,AZ,Phoenix,449,17488000,38948.77505567929,432,14810000,34282.40740740741,17,2678000
2017,county,48453,Travis,04013,Maricopa,AZ,Phoenix,1547,51838000,33508.7265675501,962,42838000,44530.14553014553,585,9000000
2017,county,48209,Hays,04013,Maricopa,AZ,Phoenix,86,2638000,30674.418604651164,74,1794000,24243.243243243243,12,844000
2017,county,48091,Comal,04013,Maricopa,AZ,Phoenix,63,3260000,51746.031746031746,47,1272000,27063.82978723404,16,1988000
2017,county,48029,Bexar,04013,Maricopa,AZ,Phoenix,990,31952000,32274.747474747473,1027,34838000,33922.10321324245,-37,-2886000
2017,county,48453,Travis,06041,Marin,CA,Bay Area,116,8388000,72310.3448275862,51,2804000,54980.39215686275,65,5584000
2017,county,48453,Travis,18097,Marion,IN,Indianapolis,148,5074000,34283.78378378379,151,3417000,22629.139072847684,-3,1657000
2017,county,48453,Travis,12083,Marion,FL,Rural Florida,59,902000,15288.135593220339,84,2240000,26666.666666666668,-25,-1338000
2017,county,48029,Bexar,18097,Marion,IN,Indianapolis,105,2762000,26304.761904761905,97,2405000,24793.81443298969,8,357000
2017,county,48029,Bexar,48321,Matagorda,TX,Rural Texas,53,875000,16509.43396226415,45,1002000,22266.666666666668,8,-127000
2017,county,48453,Travis,48323,Maverick,TX,Rural Texas,59,1424000,24135.593220338982,64,1049000,16390.625,-5,375000
2017,county,48029,Bexar,48323,Maverick,TX,Rural Texas,695,10439000,15020.143884892086,391,5445000,13925.831202046036,304,4994000
2017,county,48491,Williamson,48309,McLennan,TX,Rural Texas,270,10021000,37114.81481481482,317,8375000,26419.558359621453,-47,1646000
2017,county,48453,Travis,48309,McLennan,TX,Rural Texas,450,17523000,38940.0,508,14110000,27775.590551181103,-58,3413000
2017,county,48209,Hays,48309,McLennan,TX,Rural Texas,73,2116000,28986.301369863013,112,2107000,18812.5,-39,9000
2017,county,48029,Bexar,48309,McLennan,TX,Rural Texas,324,6407000,19774.69135802469,278,6514000,23431.654676258993,46,-107000
2017,county,48491,Williamson,37119,Mecklenburg,NC,Charlotte,86,3347000,38918.604651162794,71,2902000,40873.23943661972,15,445000
2017,county,48453,Travis,37119,Mecklenburg,NC,Charlotte,224,12891000,57549.107142857145,294,14005000,47636.054421768706,-70,-1114000
2017,county,48029,Bexar,37119,Mecklenburg,NC,Charlotte,127,5254000,41370.07874015748,209,7099000,33966.50717703349,-82,-1845000
2017,county,48029,Bexar,48325,Medina,TX,Rural Texas,1208,28219000,23360.099337748343,2043,52659000,25775.330396475772,-835,-24440000
2017,county,48491,Williamson,12086,Miami-Dade,FL,Miami,151,4324000,28635.761589403974,39,1864000,47794.8717948718,112,2460000
2017,county,48453,Travis,12086,Miami-Dade,FL,Miami,806,19508000,24203.47394540943,954,17114000,17939.203354297693,-148,2394000
2017,county,48029,Bexar,12086,Miami-Dade,FL,Miami,345,10197000,29556.521739130436,195,5673000,29092.30769230769,150,4524000
2017,county,48491,Williamson,25017,Middlesex,MA,Boston,90,5234000,58155.555555555555,51,2237000,43862.74509803922,39,2997000
2017,county,48453,Travis,25017,Middlesex,MA,Boston,475,30271000,63728.42105263158,332,14626000,44054.21686746988,143,15645000
2017,county,48453,Travis,34023,Middlesex,NJ,New York,124,5578000,44983.87096774193,84,2773000,33011.90476190476,40,2805000
2017,county,48029,Bexar,25017,Middlesex,MA,Boston,159,5382000,33849.056603773584,137,5159000,37656.93430656935,22,223000
2017,county,48029,Bexar,34023,Middlesex,NJ,New York,98,3070000,31326.530612244896,54,2440000,45185.18518518518,44,630000
2017,county,48491,Williamson,48329,Midland,TX,Rural Texas,188,7774000,41351.063829787236,69,2092000,30318.840579710144,119,5682000
2017,county,48453,Travis,48329,Midland,TX,Rural Texas,246,12009000,48817.07317073171,125,4130000,33040.0,121,7879000
2017,county,48091,Comal,48329,Midland,TX,Rural Texas,92,3761000,40880.434782608696,46,1838000,39956.52173913043,46,1923000
2017,county,48029,Bexar,48329,Midland,TX,Rural Texas,480,14244000,29675.0,467,15379000,32931.47751605996,13,-1135000
2017,county,48491,Williamson,48331,Milam,TX,Rural Texas,178,4152000,23325.842696629214,387,8583000,22178.294573643412,-209,-4431000
2017,county,48453,Travis,48331,Milam,TX,Rural Texas,67,2206000,32925.37313432836,179,4156000,23217.877094972067,-112,-1950000
2017,county,48453,Travis,55079,Milwaukee,WI,Milwaukee,253,8430000,33320.1581027668,108,2864000,26518.51851851852,145,5566000
2017,county,48029,Bexar,55079,Milwaukee,WI,Milwaukee,201,4570000,22736.3184079602,89,1983000,22280.898876404495,112,2587000
2017,county,48453,Travis,01097,Mobile,AL,Mobile,65,1219000,18753.846153846152,81,1570000,19382.716049382718,-16,-351000
2017,county,48029,Bexar,01097,Mobile,AL,Mobile,73,1149000,15739.72602739726,78,1648000,21128.20512820513,-5,-499000
2017,county,48453,Travis,34025,Monmouth,NJ,New York,60,2127000,35450.0,32,1179000,36843.75,28,948000
2017,county,48453,Travis,36055,Monroe,NY,Rochester,108,2981000,27601.85185185185,87,2739000,31482.758620689656,21,242000
2017,county,48453,Travis,06053,Monterey,CA,Rural California,31,1014000,32709.677419354837,44,1787000,40613.63636363636,-13,-773000
2017,county,48029,Bexar,06053,Monterey,CA,Rural California,226,5461000,24163.716814159292,75,2199000,29320.0,151,3262000
2017,county,48491,Williamson,48339,Montgomery,TX,Houston,379,14938000,39414.24802110818,307,13164000,42879.47882736156,72,1774000
2017,county,48491,Williamson,24031,Montgomery,MD,D.C.,78,4569000,58576.92307692308,46,1665000,36195.65217391304,32,2904000
2017,county,48453,Travis,48339,Montgomery,TX,Houston,692,44984000,65005.78034682081,513,26094000,50865.49707602339,179,18890000
2017,county,48453,Travis,24031,Montgomery,MD,D.C.,256,14515000,56699.21875,230,12812000,55704.34782608696,26,1703000
2017,county,48453,Travis,42091,Montgomery,PA,Philadelphia,60,3819000,63650.0,79,3713000,47000.0,-19,106000
2017,county,48453,Travis,39113,Montgomery,OH,Rural Ohio,58,1563000,26948.275862068964,52,1345000,25865.384615384617,6,218000
2017,county,48209,Hays,48339,Montgomery,TX,Houston,165,6844000,41478.78787878788,90,2431000,27011.11111111111,75,4413000
2017,county,48091,Comal,48339,Montgomery,TX,Houston,203,9827000,48408.86699507389,83,3242000,39060.24096385542,120,6585000
2017,county,48029,Bexar,48339,Montgomery,TX,Houston,541,14354000,26532.347504621073,516,19162000,37135.65891472868,25,-4808000
2017,county,48029,Bexar,24031,Montgomery,MD,D.C.,394,14382000,36502.53807106599,263,9526000,36220.532319391634,131,4856000
2017,county,48029,Bexar,47125,Montgomery,TN,Rural Tennessee,335,6448000,19247.761194029852,228,4698000,20605.263157894737,107,1750000
2017,county,48029,Bexar,39113,Montgomery,OH,Rural Ohio,221,5749000,26013.574660633483,214,5493000,25668.22429906542,7,256000
2017,county,48029,Bexar,01101,Montgomery,AL,Montgomery,108,2911000,26953.703703703704,117,3619000,30931.62393162393,-9,-708000
2017,county,48029,Bexar,42091,Montgomery,PA,Philadelphia,74,2191000,29608.108108108107,66,3358000,50878.78787878788,8,-1167000
2017,county,48453,Travis,34027,Morris,NJ,New York,71,7963000,112154.92957746479,36,2070000,57500.0,35,5893000
2017,county,48491,Williamson,41051,Multnomah,OR,Portland,59,3078000,52169.49152542373,48,1599000,33312.5,11,1479000
2017,county,48453,Travis,41051,Multnomah,OR,Portland,241,11894000,49352.69709543569,337,16077000,47706.23145400594,-96,-4183000
2017,county,48029,Bexar,41051,Multnomah,OR,Portland,66,1778000,26939.39393939394,64,2411000,37671.875,2,-633000
2017,county,48453,Travis,13215,Muscogee,GA,Columbus,43,686000,15953.488372093023,53,566000,10679.245283018869,-10,120000
2017,county,48029,Bexar,13215,Muscogee,GA,Columbus,187,4208000,22502.673796791445,111,2348000,21153.153153153155,76,1860000
2017,county,48453,Travis,48347,Nacogdoches,TX,Rural Texas,80,1491000,18637.5,37,1286000,34756.75675675676,43,205000
2017,county,48453,Travis,36059,Nassau,NY,New York,167,7819000,46820.35928143712,61,2256000,36983.60655737705,106,5563000
2017,county,48029,Bexar,36059,Nassau,NY,New York,64,2235000,34921.875,44,1529000,34750.0,20,706000
2017,county,48453,Travis,10003,New Castle,DE,Rural Delaware,77,2383000,30948.051948051947,44,1087000,24704.545454545456,33,1296000
2017,county,48029,Bexar,10003,New Castle,DE,Rural Delaware,82,2716000,33121.95121951219,50,1380000,27600.0,32,1336000
2017,county,48453,Travis,37129,New Hanover,NC,Rural North Carolina,57,2467000,43280.70175438596,40,1688000,42200.0,17,779000
2017,county,48453,Travis,09009,New Haven,CT,New Haven,143,5086000,35566.43356643357,96,2844000,29625.0,47,2242000
2017,county,48029,Bexar,09009,New Haven,CT,New Haven,104,4634000,44557.692307692305,49,1062000,21673.469387755104,55,3572000
2017,county,48491,Williamson,36061,New York,NY,New York,54,3161000,58537.03703703704,25,1784000,71360.0,29,1377000
2017,county,48453,Travis,36061,New York,NY,New York,741,92035000,124203.77867746289,497,45445000,91438.63179074446,244,46590000
2017,county,48029,Bexar,36061,New York,NY,New York,167,10573000,63311.377245508986,128,9669000,75539.0625,39,904000
2017,county,48029,Bexar,51700,Newport News city,VA,Hampton Roads,165,3491000,21157.575757575756,78,2131000,27320.51282051282,87,1360000
2017,county,48453,Travis,25021,Norfolk,MA,Boston,128,11065000,86445.3125,108,6568000,60814.81481481482,20,4497000
2017,county,48453,Travis,51710,Norfolk city,VA,Hampton Roads,40,1682000,42050.0,45,1122000,24933.333333333332,-5,560000
2017,county,48029,Bexar,51710,Norfolk city,VA,Hampton Roads,97,2204000,22721.649484536083,103,1964000,19067.961165048542,-6,240000
2017,county,48491,Williamson,48355,Nueces,TX,Rural Texas,342,9565000,27967.83625730994,197,6260000,31776.649746192892,145,3305000
2017,county,48453,Travis,48355,Nueces,TX,Rural Texas,696,20207000,29033.045977011494,391,13917000,35593.35038363171,305,6290000
2017,county,48209,Hays,48355,Nueces,TX,Rural Texas,178,5076000,28516.85393258427,108,3268000,30259.25925925926,70,1808000
2017,county,48091,Comal,48355,Nueces,TX,Rural Texas,265,11482000,43328.301886792455,94,2961000,31500.0,171,8521000
2017,county,48029,Bexar,48355,Nueces,TX,Rural Texas,2184,54551000,24977.5641025641,1092,27453000,25140.10989010989,1092,27098000
2017,county,48491,Williamson,26125,Oakland,MI,Detroit,99,4085000,41262.62626262626,64,2338000,36531.25,35,1747000
2017,county,48453,Travis,26125,Oakland,MI,Detroit,179,10350000,57821.22905027933,149,7175000,48154.36241610738,30,3175000
2017,county,48029,Bexar,26125,Oakland,MI,Detroit,122,4239000,34745.901639344265,114,4808000,42175.43859649123,8,-569000
2017,county,48029,Bexar,12091,Okaloosa,FL,FL Panhandle,356,8874000,24926.96629213483,336,8879000,26425.595238095237,20,-5000
2017,county,48491,Williamson,40109,Oklahoma,OK,Oklahoma City,132,4386000,33227.27272727273,72,2711000,37652.77777777778,60,1675000
2017,county,48453,Travis,40109,Oklahoma,OK,Oklahoma City,274,11544000,42131.38686131387,202,7078000,35039.60396039604,72,4466000
2017,county,48029,Bexar,40109,Oklahoma,OK,Oklahoma City,354,10952000,30937.853107344632,318,8913000,28028.30188679245,36,2039000
2017,county,48029,Bexar,37133,Onslow,NC,Rural North Carolina,314,4708000,14993.630573248407,133,1746000,13127.819548872181,181,2962000
2017,county,48491,Williamson,06059,Orange,CA,Los Angeles,542,20535000,37887.45387453875,166,6777000,40825.301204819276,376,13758000
2017,county,48491,Williamson,12095,Orange,FL,Orlando,102,3256000,31921.56862745098,77,2253000,29259.74025974026,25,1003000
2017,county,48453,Travis,06059,Orange,CA,Los Angeles,920,42970000,46706.52173913043,508,26234000,51641.73228346457,412,16736000
2017,county,48453,Travis,12095,Orange,FL,Orlando,378,11768000,31132.275132275132,369,9394000,25457.9945799458,9,2374000
2017,county,48453,Travis,36071,Orange,NY,Rural New York,46,1620000,35217.391304347824,49,1067000,21775.51020408163,-3,553000
2017,county,48453,Travis,37135,Orange,NC,Raleigh,46,2085000,45326.086956521736,62,1531000,24693.548387096773,-16,554000
2017,county,48453,Travis,48361,Orange,TX,Rural Texas,37,1251000,33810.81081081081,40,864000,21600.0,-3,387000
2017,county,48209,Hays,06059,Orange,CA,Los Angeles,116,6144000,52965.51724137931,39,1111000,28487.17948717949,77,5033000
2017,county,48029,Bexar,06059,Orange,CA,Los Angeles,556,18474000,33226.61870503597,282,9205000,32641.843971631206,274,9269000
2017,county,48029,Bexar,12095,Orange,FL,Orlando,289,7340000,25397.923875432527,232,7080000,30517.241379310344,57,260000
2017,county,48029,Bexar,36071,Orange,NY,Rural New York,104,4105000,39471.153846153844,55,1789000,32527.272727272728,49,2316000
2017,county,48029,Bexar,48361,Orange,TX,Rural Texas,41,1048000,25560.975609756097,38,958000,25210.526315789473,3,90000
2017,county,48453,Travis,22071,Orleans Parish,LA,New Orleans,216,7930000,36712.96296296296,151,4820000,31920.529801324505,65,3110000
2017,county,48029,Bexar,22071,Orleans Parish,LA,New Orleans,123,2936000,23869.91869918699,120,4200000,35000.0,3,-1264000
2017,county,48453,Travis,12097,Osceola,FL,Orlando,60,1332000,22200.0,73,939000,12863.013698630137,-13,393000
2017,county,48029,Bexar,12097,Osceola,FL,Orlando,54,662000,12259.25925925926,67,1863000,27805.97014925373,-13,-1201000
2017,county,48029,Bexar,35035,Otero,NM,Rural New Mexico,150,3262000,21746.666666666668,54,1146000,21222.222222222223,96,2116000
2017,county,48491,Williamson,12099,Palm Beach,FL,Miami,80,4251000,53137.5,55,2115000,38454.545454545456,25,2136000
2017,county,48453,Travis,12099,Palm Beach,FL,Miami,382,9637000,25227.748691099478,400,8562000,21405.0,-18,1075000
2017,county,48029,Bexar,12099,Palm Beach,FL,Miami,147,4314000,29346.938775510203,112,4882000,43589.28571428572,35,-568000
2017,county,48491,Williamson,48367,Parker,TX,Dallas-Fort Worth,32,1541000,48156.25,51,1927000,37784.313725490196,-19,-386000
2017,county,48453,Travis,48367,Parker,TX,Dallas-Fort Worth,69,2395000,34710.14492753623,101,4064000,40237.623762376235,-32,-1669000
2017,county,48029,Bexar,48367,Parker,TX,Dallas-Fort Worth,64,1388000,21687.5,115,4197000,36495.65217391304,-51,-2809000
2017,county,48453,Travis,12101,Pasco,FL,Tampa,73,3319000,45465.75342465754,98,2014000,20551.020408163266,-25,1305000
2017,county,48029,Bexar,12101,Pasco,FL,Tampa,63,1622000,25746.031746031746,68,2089000,30720.58823529412,-5,-467000
2017,county,48029,Bexar,46103,Pennington,SD,Rural South Dakota,92,1601000,17402.17391304348,43,1131000,26302.325581395347,49,470000
2017,county,48453,Travis,42101,Philadelphia,PA,Philadelphia,253,11025000,43577.07509881423,270,7059000,26144.444444444445,-17,3966000
2017,county,48029,Bexar,42101,Philadelphia,PA,Philadelphia,88,3163000,35943.181818181816,65,1616000,24861.53846153846,23,1547000
2017,county,48491,Williamson,53053,Pierce,WA,Seattle,110,3693000,33572.72727272727,70,2696000,38514.28571428572,40,997000
2017,county,48453,Travis,53053,Pierce,WA,Seattle,163,4596000,28196.31901840491,148,4781000,32304.054054054053,15,-185000
2017,county,48029,Bexar,53053,Pierce,WA,Seattle,619,13836000,22352.180936995155,525,12565000,23933.333333333332,94,1271000
2017,county,48491,Williamson,04019,Pima,AZ,Tucson,83,2711000,32662.650602409638,86,3008000,34976.74418604651,-3,-297000
2017,county,48453,Travis,04019,Pima,AZ,Tucson,236,8951000,37927.96610169492,215,6664000,30995.3488372093,21,2287000
2017,county,48029,Bexar,04019,Pima,AZ,Tucson,478,10177000,21290.7949790795,302,9404000,31139.07284768212,176,773000
2017,county,48029,Bexar,04021,Pinal,AZ,Phoenix,69,1049000,15202.898550724638,110,2242000,20381.81818181818,-41,-1193000
2017,county,48491,Williamson,12103,Pinellas,FL,Tampa,58,2701000,46568.96551724138,74,2835000,38310.81081081081,-16,-134000
2017,county,48453,Travis,12103,Pinellas,FL,Tampa,169,5051000,29887.57396449704,237,6789000,28645.569620253165,-68,-1738000
2017,county,48029,Bexar,12103,Pinellas,FL,Tampa,117,4965000,42435.89743589744,97,4095000,42216.49484536082,20,870000
2017,county,48453,Travis,06061,Placer,CA,Sacramento,41,2005000,48902.439024390245,42,1917000,45642.857142857145,-1,88000
2017,county,48029,Bexar,06061,Placer,CA,Sacramento,42,1810000,43095.23809523809,95,3017000,31757.894736842107,-53,-1207000
2017,county,48491,Williamson,48373,Polk,TX,Rural Texas,42,1090000,25952.380952380954,68,2651000,38985.294117647056,-26,-1561000
2017,county,48453,Travis,12105,Polk,FL,Orlando,98,1678000,17122.448979591838,153,2142000,14000.0,-55,-464000
2017,county,48453,Travis,19153,Polk,IA,Rural Iowa,72,4077000,56625.0,54,1715000,31759.25925925926,18,2362000
2017,county,48453,Travis,48373,Polk,TX,Rural Texas,37,1137000,30729.72972972973,81,3431000,42358.02469135803,-44,-2294000
2017,county,48029,Bexar,12105,Polk,FL,Orlando,60,1768000,29466.666666666668,85,1535000,18058.823529411766,-25,233000
2017,county,48029,Bexar,19153,Polk,IA,Rural Iowa,64,2110000,32968.75,84,1671000,19892.85714285714,-20,439000
2017,county,48029,Bexar,51740,Portsmouth city,VA,Hampton Roads,50,974000,19480.0,53,998000,18830.188679245282,-3,-24000
2017,county,48453,Travis,48375,Potter,TX,Rural Texas,74,3783000,51121.62162162162,54,957000,17722.222222222223,20,2826000
2017,county,48029,Bexar,48375,Potter,TX,Rural Texas,109,2381000,21844.036697247706,79,1269000,16063.291139240506,30,1112000
2017,county,48453,Travis,24033,Prince George,MD,Rural Maryland,92,2720000,29565.217391304348,75,2372000,31626.666666666668,17,348000
2017,county,48029,Bexar,24033,Prince George,MD,Rural Maryland,216,6509000,30134.25925925926,148,5337000,36060.81081081081,68,1172000
2017,county,48029,Bexar,51153,Prince William,VA,Rural Virginia,222,8529000,38418.91891891892,183,5181000,28311.475409836065,39,3348000
2017,county,48453,Travis,44007,Providence,RI,Providence,61,2174000,35639.34426229508,67,2302000,34358.20895522388,-6,-128000
2017,county,48453,Travis,05119,Pulaski,AR,Little Rock,104,3149000,30278.846153846152,119,2701000,22697.47899159664,-15,448000
2017,county,48029,Bexar,05119,Pulaski,AR,Little Rock,163,4738000,29067.484662576688,130,3011000,23161.53846153846,33,1727000
2017,county,48029,Bexar,29169,Pulaski,MO,Rural Missouri,139,3739000,26899.280575539568,95,2133000,22452.63157894737,44,1606000
2017,county,48453,Travis,36081,Queens,NY,New York,286,13897000,48590.90909090909,172,3763000,21877.906976744187,114,10134000
2017,county,48029,Bexar,36081,Queens,NY,New York,161,4172000,25913.043478260868,58,1413000,24362.068965517243,103,2759000
2017,county,48453,Travis,27123,Ramsey,MN,Minneapolis,62,3242000,52290.32258064516,79,3611000,45708.86075949367,-17,-369000
2017,county,48029,Bexar,27123,Ramsey,MN,Minneapolis,63,1026000,16285.714285714286,46,1678000,36478.260869565216,17,-652000
2017,county,48453,Travis,48381,Randall,TX,Rural Texas,116,4528000,39034.48275862069,63,1470000,23333.333333333332,53,3058000
2017,county,48029,Bexar,48381,Randall,TX,Rural Texas,146,4662000,31931.50684931507,98,2876000,29346.938775510203,48,1786000
2017,county,48453,Travis,45079,Richland,SC,Columbia,124,5871000,47346.77419354839,59,1000000,16949.15254237288,65,4871000
2017,county,48029,Bexar,45079,Richland,SC,Columbia,156,4457000,28570.51282051282,141,3503000,24843.971631205673,15,954000
2017,county,48029,Bexar,13245,Richmond,GA,Rural Georgia,134,3038000,22671.641791044774,129,2587000,20054.263565891473,5,451000
2017,county,48453,Travis,51760,Richmond city,VA,Richmond,34,1523000,44794.117647058825,78,3658000,46897.4358974359,-44,-2135000
2017,county,48029,Bexar,20161,Riley,KS,Rural Kansas,48,1093000,22770.833333333332,76,1292000,17000.0,-28,-199000
2017,county,48491,Williamson,06065,Riverside,CA,San Bernardino-Riverside,255,6940000,27215.686274509804,107,2704000,25271.028037383177,148,4236000
2017,county,48453,Travis,06065,Riverside,CA,San Bernardino-Riverside,1178,17689000,15016.129032258064,276,5285000,19148.55072463768,902,12404000
2017,county,48029,Bexar,06065,Riverside,CA,San Bernardino-Riverside,465,11063000,23791.397849462366,355,7494000,21109.859154929578,110,3569000
2017,county,48453,Travis,33015,Rockingham,NH,Boston,59,2535000,42966.101694915254,35,1764000,50400.0,24,771000
2017,county,48453,Travis,48397,Rockwall,TX,Dallas-Fort Worth,55,1701000,30927.272727272728,89,2004000,22516.85393258427,-34,-303000
2017,county,48029,Bexar,48397,Rockwall,TX,Dallas-Fort Worth,54,2225000,41203.7037037037,103,4184000,40621.35922330097,-49,-1959000
2017,county,48029,Bexar,47149,Rutherford,TN,Nashville,42,953000,22690.47619047619,53,1585000,29905.66037735849,-11,-632000
2017,county,48491,Williamson,06067,Sacramento,CA,Sacramento,95,3254000,34252.63157894737,56,1469000,26232.14285714286,39,1785000
2017,county,48453,Travis,06067,Sacramento,CA,Sacramento,212,8523000,40202.83018867925,256,9838000,38429.6875,-44,-1315000
2017,county,48029,Bexar,06067,Sacramento,CA,Sacramento,214,4385000,20490.654205607476,145,3380000,23310.344827586207,69,1005000
2017,county,48491,Williamson,49035,Salt Lake,UT,Salt Lake,125,4605000,36840.0,86,2290000,26627.906976744187,39,2315000
2017,county,48453,Travis,49035,Salt Lake,UT,Salt Lake,291,10667000,36656.35738831615,234,10659000,45551.282051282054,57,8000
2017,county,48029,Bexar,49035,Salt Lake,UT,Salt Lake,258,5882000,22798.4496124031,223,5689000,25511.210762331837,35,193000
2017,county,48491,Williamson,06071,San Bernardino,CA,San Bernardino-Riverside,200,8490000,42450.0,62,1554000,25064.516129032258,138,6936000
2017,county,48453,Travis,06071,San Bernardino,CA,San Bernardino-Riverside,310,5235000,16887.09677419355,255,4182000,16400.0,55,1053000
2017,county,48029,Bexar,06071,San Bernardino,CA,San Bernardino-Riverside,424,8516000,20084.905660377357,308,5994000,19461.03896103896,116,2522000
2017,county,48491,Williamson,06073,San Diego,CA,San Diego,627,21805000,34776.71451355662,183,7067000,38617.48633879781,444,14738000
2017,county,48453,Travis,06073,San Diego,CA,San Diego,971,41504000,42743.56333676622,679,32121000,47306.332842415315,292,9383000
2017,county,48209,Hays,06073,San Diego,CA,San Diego,126,4619000,36658.730158730155,67,1683000,25119.402985074626,59,2936000
2017,county,48091,Comal,06073,San Diego,CA,San Diego,101,4945000,48960.39603960396,46,1438000,31260.869565217392,55,3507000
2017,county,48029,Bexar,06073,San Diego,CA,San Diego,1385,60360000,43581.22743682311,815,21094000,25882.208588957055,570,39266000
2017,county,48453,Travis,06075,San Francisco,CA,Bay Area,553,64017000,115763.1103074141,375,29794000,79450.66666666667,178,34223000
2017,county,48029,Bexar,06075,San Francisco,CA,Bay Area,56,3605000,64375.0,56,4673000,83446.42857142857,0,-1068000
2017,county,48453,Travis,06077,San Joaquin,CA,Bay Area,75,2195000,29266.666666666668,44,610000,13863.636363636364,31,1585000
2017,county,48029,Bexar,06077,San Joaquin,CA,Bay Area,99,2061000,20818.18181818182,37,686000,18540.54054054054,62,1375000
2017,county,48453,Travis,06081,San Mateo,CA,Bay Area,379,30705000,81015.83113456465,191,22294000,116722.51308900524,188,8411000
2017,county,48029,Bexar,06081,San Mateo,CA,Bay Area,53,2699000,50924.52830188679,67,2568000,38328.35820895522,-14,131000
2017,county,48491,Williamson,48409,San Patricio,TX,Rural Texas,55,1377000,25036.363636363636,54,1676000,31037.037037037036,1,-299000
2017,county,48453,Travis,48409,San Patricio,TX,Rural Texas,86,3140000,36511.62790697674,62,2870000,46290.32258064516,24,270000
2017,county,48029,Bexar,48409,San Patricio,TX,Rural Texas,243,5075000,20884.77366255144,174,4459000,25626.436781609194,69,616000
2017,county,48453,Travis,35043,Sandoval,NM,Albuquerque,36,1649000,45805.555555555555,31,1124000,36258.06451612903,5,525000
2017,county,48029,Bexar,35043,Sandoval,NM,Albuquerque,84,2038000,24261.904761904763,73,2785000,38150.68493150685,11,-747000
2017,county,48453,Travis,06083,Santa Barbara,CA,Rural California,94,3903000,41521.27659574468,77,2846000,36961.03896103896,17,1057000
2017,county,48029,Bexar,06083,Santa Barbara,CA,Rural California,100,2549000,25490.0,99,2256000,22787.878787878788,1,293000
2017,county,48491,Williamson,06085,Santa Clara,CA,Bay Area,710,41860000,58957.74647887324,165,11268000,68290.90909090909,545,30592000
2017,county,48453,Travis,06085,Santa Clara,CA,Bay Area,1201,99581000,82915.07077435471,795,64313000,80896.85534591194,406,35268000
2017,county,48029,Bexar,06085,Santa Clara,CA,Bay Area,229,10440000,45589.51965065502,179,8302000,46379.88826815642,50,2138000
2017,county,48453,Travis,06087,Santa Cruz,CA,Bay Area,77,5083000,66012.98701298701,38,1430000,37631.57894736842,39,3653000
2017,county,48453,Travis,35049,Santa Fe,NM,Rural New Mexico,63,4825000,76587.30158730158,113,5689000,50345.13274336283,-50,-864000
2017,county,48029,Bexar,35049,Santa Fe,NM,Rural New Mexico,52,1495000,28750.0,37,2414000,65243.24324324324,15,-919000
2017,county,48029,Bexar,12113,Santa Rosa,FL,FL Panhandle,165,3585000,21727.272727272728,199,5152000,25889.447236180906,-34,-1567000
2017,county,48453,Travis,12115,Sarasota,FL,S.W. Florida,78,1872000,24000.0,64,3111000,48609.375,14,-1239000
2017,county,48029,Bexar,12115,Sarasota,FL,S.W. Florida,36,1013000,28138.88888888889,51,1793000,35156.86274509804,-15,-780000
2017,county,48029,Bexar,31153,Sarpy,NE,Omaha,217,5417000,24963.133640552995,176,3975000,22585.227272727272,41,1442000
2017,county,48453,Travis,20173,Sedgwick,KS,Rural Kansas,74,4038000,54567.56756756757,78,2304000,29538.46153846154,-4,1734000
2017,county,48029,Bexar,20173,Sedgwick,KS,Rural Kansas,149,3389000,22744.96644295302,126,3722000,29539.68253968254,23,-333000
2017,county,48453,Travis,12117,Seminole,FL,Orlando,101,3926000,38871.28712871287,85,2393000,28152.941176470587,16,1533000
2017,county,48029,Bexar,12117,Seminole,FL,Orlando,61,1635000,26803.27868852459,79,2674000,33848.101265822785,-18,-1039000
2017,county,48453,Travis,47157,Shelby,TN,Memphis,267,8206000,30734.082397003745,275,6001000,21821.81818181818,-8,2205000
2017,county,48029,Bexar,47157,Shelby,TN,Memphis,226,6094000,26964.601769911504,120,3716000,30966.666666666668,106,2378000
2017,county,48491,Williamson,48423,Smith,TX,Rural Texas,130,3393000,26100.0,132,3647000,27628.78787878788,-2,-254000
2017,county,48453,Travis,48423,Smith,TX,Rural Texas,214,8304000,38803.73831775701,203,7162000,35280.7881773399,11,1142000
2017,county,48029,Bexar,48423,Smith,TX,Rural Texas,190,4155000,21868.42105263158,108,2372000,21962.962962962964,82,1783000
2017,county,48491,Williamson,53061,Snohomish,WA,Seattle,107,3022000,28242.99065420561,72,5706000,79250.0,35,-2684000
2017,county,48453,Travis,53061,Snohomish,WA,Seattle,139,4968000,35741.0071942446,113,3867000,34221.238938053095,26,1101000
2017,county,48029,Bexar,53061,Snohomish,WA,Seattle,155,5904000,38090.32258064516,129,3399000,26348.837209302324,26,2505000
2017,county,48453,Travis,06095,Solano,CA,Bay Area,65,2277000,35030.769230769234,53,1226000,23132.075471698114,12,1051000
2017,county,48029,Bexar,06095,Solano,CA,Bay Area,343,10836000,31591.836734693876,318,9310000,29276.729559748426,25,1526000
2017,county,48453,Travis,06097,Sonoma,CA,Bay Area,78,4253000,54525.64102564102,54,3899000,72203.70370370371,24,354000
2017,county,48453,Travis,53063,Spokane,WA,Spokane,50,835000,16700.0,81,2236000,27604.938271604937,-31,-1401000
2017,county,48029,Bexar,53063,Spokane,WA,Spokane,187,4207000,22497.326203208555,138,4230000,30652.17391304348,49,-23000
2017,county,48029,Bexar,17163,St. Clair,IL,St. Louis,264,6502000,24628.78787878788,167,3623000,21694.610778443115,97,2879000
2017,county,48453,Travis,18141,St. Joseph,IN,Rural Indiana,32,2021000,63156.25,48,814000,16958.333333333332,-16,1207000
2017,county,48453,Travis,29189,St. Louis,MO,St. Louis,193,11721000,60730.56994818653,112,6368000,56857.142857142855,81,5353000
2017,county,48029,Bexar,29189,St. Louis,MO,St. Louis,142,6266000,44126.76056338028,106,5041000,47556.6037735849,36,1225000
2017,county,48453,Travis,29510,St. Louis city,MO,Rural Missouri,101,3596000,35603.960396039605,83,2919000,35168.67469879518,18,677000
2017,county,48029,Bexar,29510,St. Louis city,MO,Rural Missouri,57,1967000,34508.771929824565,39,1063000,27256.410256410258,18,904000
2017,county,48453,Travis,12111,St. Lucie,FL,Atlantic Coast,57,582000,10210.526315789473,50,1061000,21220.0,7,-479000
2017,county,48453,Travis,22103,St. Tammany Parish,LA,New Orleans,67,2449000,36552.23880597015,44,1953000,44386.36363636364,23,496000
2017,county,48029,Bexar,22103,St. Tammany Parish,LA,New Orleans,56,2122000,37892.857142857145,56,1529000,27303.571428571428,0,593000
2017,county,48029,Bexar,51179,Stafford,VA,Rural Virginia,84,2911000,34654.76190476191,91,2149000,23615.384615384617,-7,762000
2017,county,48453,Travis,06099,Stanislaus,CA,Bay Area,40,946000,23650.0,55,1107000,20127.272727272728,-15,-161000
2017,county,48029,Bexar,48427,Starr,TX,Rural Texas,62,1542000,24870.967741935485,51,757000,14843.137254901962,11,785000
2017,county,48453,Travis,25025,Suffolk,MA,Boston,250,17045000,68180.0,149,7785000,52248.32214765101,101,9260000
2017,county,48453,Travis,36103,Suffolk,NY,New York,145,9888000,68193.10344827586,82,2449000,29865.853658536584,63,7439000
2017,county,48029,Bexar,36103,Suffolk,NY,New York,75,1711000,22813.333333333332,49,1361000,27775.51020408163,26,350000
2017,county,48029,Bexar,25025,Suffolk,MA,Boston,46,2043000,44413.04347826087,50,2847000,56940.0,-4,-804000
2017,county,48029,Bexar,39153,Summit,OH,Rural Ohio,33,1235000,37424.242424242424,50,1140000,22800.0,-17,95000
2017,county,48029,Bexar,45085,Sumter,SC,Rural South Carolina,142,3096000,21802.816901408452,93,2313000,24870.967741935485,49,783000
2017,county,48491,Williamson,48439,Tarrant,TX,Dallas-Fort Worth,849,30707000,36168.433451118966,748,23451000,31351.604278074865,101,7256000
2017,county,48453,Travis,48439,Tarrant,TX,Dallas-Fort Worth,1409,59659000,42341.37686302342,1494,52385000,35063.587684069615,-85,7274000
2017,county,48209,Hays,48439,Tarrant,TX,Dallas-Fort Worth,197,11628000,59025.3807106599,226,6435000,28473.451327433628,-29,5193000
2017,county,48091,Comal,48439,Tarrant,TX,Dallas-Fort Worth,235,8877000,37774.46808510638,134,4462000,33298.50746268657,101,4415000
2017,county,48029,Bexar,48439,Tarrant,TX,Dallas-Fort Worth,1353,39248000,29008.130081300813,1691,50640000,29946.777054997045,-338,-11392000
2017,county,48491,Williamson,48441,Taylor,TX,Rural Texas,123,2759000,22430.89430894309,106,2876000,27132.075471698114,17,-117000
2017,county,48453,Travis,48441,Taylor,TX,Rural Texas,138,4206000,30478.260869565216,110,2849000,25900.0,28,1357000
2017,county,48029,Bexar,48441,Taylor,TX,Rural Texas,365,8368000,22926.027397260274,223,5341000,23950.67264573991,142,3027000
2017,county,48453,Travis,53067,Thurston,WA,Rural Washington,64,1815000,28359.375,77,2077000,26974.025974025975,-13,-262000
2017,county,48029,Bexar,53067,Thurston,WA,Rural Washington,201,5464000,27184.079601990048,215,4528000,21060.46511627907,-14,936000
2017,county,48491,Williamson,48451,Tom Green,TX,Rural Texas,129,3719000,28829.457364341084,84,1798000,21404.761904761905,45,1921000
2017,county,48453,Travis,48451,Tom Green,TX,Rural Texas,153,4035000,26372.549019607843,83,3460000,41686.74698795181,70,575000
2017,county,48029,Bexar,48451,Tom Green,TX,Rural Texas,523,12126000,23185.46845124283,316,6952000,22000.0,207,5174000
2017,county,48491,Williamson,48453,Travis,TX,Austin,26362,899964000,34138.684470070555,16836,623181000,37014.7897362794,9526,276783000
2017,county,48209,Hays,48453,Travis,TX,Austin,10133,351060000,34645.21859271687,4463,150316000,33680.48397938607,5670,200744000
2017,county,48091,Comal,48453,Travis,TX,Austin,655,26875000,41030.53435114504,391,14345000,36687.97953964194,264,12530000
2017,county,48029,Bexar,48453,Travis,TX,Austin,3182,106527000,33478.001257071024,3239,143077000,44173.20160543377,-57,-36550000
2017,county,48491,Williamson,40143,Tulsa,OK,Tulsa,59,1978000,33525.42372881356,58,1418000,24448.275862068964,1,560000
2017,county,48453,Travis,40143,Tulsa,OK,Tulsa,149,5414000,36335.57046979866,147,4487000,30523.809523809523,2,927000
2017,county,48029,Bexar,40143,Tulsa,OK,Tulsa,171,4847000,28345.02923976608,152,3916000,25763.157894736843,19,931000
2017,county,48453,Travis,34039,Union,NJ,New York,42,2799000,66642.85714285714,48,1233000,25687.5,-6,1566000
2017,county,48491,Williamson,49049,Utah,UT,Rural Utah,126,2546000,20206.349206349205,87,2115000,24310.344827586207,39,431000
2017,county,48453,Travis,49049,Utah,UT,Rural Utah,160,3937000,24606.25,103,4190000,40679.611650485436,57,-253000
2017,county,48029,Bexar,49049,Utah,UT,Rural Utah,134,2374000,17716.417910447763,147,3769000,25639.455782312925,-13,-1395000
2017,county,48453,Travis,48463,Uvalde,TX,Rural Texas,36,869000,24138.88888888889,33,814000,24666.666666666668,3,55000
2017,county,48029,Bexar,48463,Uvalde,TX,Rural Texas,303,8287000,27349.83498349835,255,4999000,19603.92156862745,48,3288000
2017,county,48453,Travis,48465,Val Verde,TX,Rural Texas,47,1148000,24425.531914893618,40,1145000,28625.0,7,3000
2017,county,48029,Bexar,48465,Val Verde,TX,Rural Texas,458,10585000,23111.353711790394,315,5550000,17619.04761904762,143,5035000
2017,county,48453,Travis,06111,Ventura,CA,Los Angeles,185,6517000,35227.02702702703,138,6016000,43594.20289855073,47,501000
2017,county,48029,Bexar,06111,Ventura,CA,Los Angeles,181,5884000,32508.28729281768,82,2729000,33280.48780487805,99,3155000
2017,county,48029,Bexar,22115,Vernon Parish,LA,Rural Louisiana,214,3796000,17738.317757009347,92,1708000,18565.217391304348,122,2088000
2017,county,48491,Williamson,48469,Victoria,TX,Rural Texas,100,3448000,34480.0,59,1211000,20525.42372881356,41,2237000
2017,county,48453,Travis,48469,Victoria,TX,Rural Texas,176,3741000,21255.68181818182,110,2821000,25645.454545454544,66,920000
2017,county,48209,Hays,48469,Victoria,TX,Rural Texas,82,1887000,23012.19512195122,47,1193000,25382.978723404256,35,694000
2017,county,48029,Bexar,48469,Victoria,TX,Rural Texas,284,6454000,22725.352112676057,137,3594000,26233.576642335767,147,2860000
2017,county,48453,Travis,51810,Virginia Beach city,VA,Hampton Roads,98,2489000,25397.95918367347,47,1888000,40170.21276595745,51,601000
2017,county,48029,Bexar,51810,Virginia Beach city,VA,Hampton Roads,242,4833000,19971.07438016529,186,3515000,18897.84946236559,56,1318000
2017,county,48453,Travis,12127,Volusia,FL,Atlantic Coast,89,1490000,16741.573033707864,95,1639000,17252.63157894737,-6,-149000
2017,county,48029,Bexar,12127,Volusia,FL,Atlantic Coast,56,913000,16303.57142857143,62,1681000,27112.90322580645,-6,-768000
2017,county,48491,Williamson,37183,Wake,NC,Raleigh,113,5364000,47469.02654867257,100,3607000,36070.0,13,1757000
2017,county,48453,Travis,37183,Wake,NC,Raleigh,281,13881000,49398.57651245552,307,12164000,39622.14983713355,-26,1717000
2017,county,48029,Bexar,37183,Wake,NC,Raleigh,158,4500000,28481.01265822785,193,6982000,36176.16580310881,-35,-2482000
2017,county,48453,Travis,48471,Walker,TX,Rural Texas,56,1819000,32482.14285714286,57,1485000,26052.63157894737,-1,334000
2017,county,48029,Bexar,38101,Ward,ND,Rural North Dakota,124,3383000,27282.25806451613,89,1951000,21921.34831460674,35,1432000
2017,county,48491,Williamson,41067,Washington,OR,Portland,138,7084000,51333.333333333336,73,2912000,39890.41095890411,65,4172000
2017,county,48453,Travis,41067,Washington,OR,Portland,264,14241000,53943.181818181816,244,10265000,42069.67213114754,20,3976000
2017,county,48453,Travis,05143,Washington,AR,Rural Arkansas,67,2120000,31641.79104477612,81,2720000,33580.246913580246,-14,-600000
2017,county,48453,Travis,48477,Washington,TX,Rural Texas,48,1543000,32145.833333333332,61,3111000,51000.0,-13,-1568000
2017,county,48029,Bexar,41067,Washington,OR,Portland,98,2714000,27693.877551020407,150,5142000,34280.0,-52,-2428000
2017,county,48453,Travis,32031,Washoe,NV,Rural Nevada,90,3923000,43588.88888888889,122,5170000,42377.04918032787,-32,-1247000
2017,county,48029,Bexar,32031,Washoe,NV,Rural Nevada,110,2306000,20963.636363636364,126,4217000,33468.25396825397,-16,-1911000
2017,county,48453,Travis,26161,Washtenaw,MI,Rural Michigan,103,5003000,48572.81553398058,80,3901000,48762.5,23,1102000
2017,county,48029,Bexar,55133,Waukesha,WI,Milwaukee,44,1696000,38545.454545454544,52,1111000,21365.384615384617,-8,585000
2017,county,48453,Travis,26163,Wayne,MI,Detroit,294,5805000,19744.897959183672,338,5716000,16911.242603550298,-44,89000
2017,county,48029,Bexar,26163,Wayne,MI,Detroit,161,3474000,21577.639751552793,114,2553000,22394.736842105263,47,921000
2017,county,48453,Travis,48479,Webb,TX,Rural Texas,285,6928000,24308.77192982456,164,2921000,17810.975609756097,121,4007000
2017,county,48209,Hays,48479,Webb,TX,Rural Texas,81,1001000,12358.024691358025,46,873000,18978.260869565216,35,128000
2017,county,48029,Bexar,48479,Webb,TX,Rural Texas,1830,43483000,23761.20218579235,795,12510000,15735.849056603774,1035,30973000
2017,county,48029,Bexar,08123,Weld,CO,Rural Colorado,47,1524000,32425.531914893618,97,3122000,32185.567010309278,-50,-1598000
2017,county,48453,Travis,36119,Westchester,NY,New York,199,20929000,105170.85427135679,113,4471000,39566.37168141593,86,16458000
2017,county,48453,Travis,53073,Whatcom,WA,Rural Washington,42,1256000,29904.761904761905,37,979000,26459.45945945946,5,277000
2017,county,48491,Williamson,48485,Wichita,TX,Rural Texas,60,927000,15450.0,61,1382000,22655.737704918032,-1,-455000
2017,county,48453,Travis,48485,Wichita,TX,Rural Texas,87,3036000,34896.55172413793,75,2311000,30813.333333333332,12,725000
2017,county,48029,Bexar,48485,Wichita,TX,Rural Texas,224,5355000,23906.25,115,2884000,25078.260869565216,109,2471000
2017,county,48453,Travis,17197,Will,IL,Chicago,87,4513000,51873.5632183908,40,661000,16525.0,47,3852000
2017,county,48029,Bexar,17197,Will,IL,Chicago,109,3928000,36036.69724770642,63,1039000,16492.06349206349,46,2889000
2017,county,48453,Travis,48491,Williamson,TX,Austin,16836,623181000,37014.7897362794,26362,899964000,34138.684470070555,-9526,-276783000
2017,county,48209,Hays,48491,Williamson,TX,Austin,956,30810000,32228.03347280335,909,28820000,31705.170517051705,47,1990000
2017,county,48091,Comal,48491,Williamson,TX,Austin,295,11399000,38640.67796610169,166,7286000,43891.56626506024,129,4113000
2017,county,48029,Bexar,48491,Williamson,TX,Austin,962,28992000,30137.214137214138,1251,39299000,31414.068745003995,-289,-10307000
2017,county,48091,Comal,48493,Wilson,TX,Rural Texas,114,4320000,37894.73684210526,94,3302000,35127.65957446808,20,1018000
2017,county,48029,Bexar,48493,Wilson,TX,Rural Texas,1079,26298000,24372.5671918443,2113,65285000,30896.82915286323,-1034,-38987000
2017,county,48453,Travis,25027,Worcester,MA,Rural Massachusetts,104,8181000,78663.46153846153,60,1301000,21683.333333333332,44,6880000
2017,county,48029,Bexar,25027,Worcester,MA,Rural Massachusetts,47,1238000,26340.425531914894,45,1434000,31866.666666666668,2,-196000
2017,county,48453,Travis,04025,Yavapai,AZ,Rural Arizona,37,1192000,32216.216216216217,35,2536000,72457.14285714286,2,-1344000
2017,county,48029,Bexar,51199,York,VA,Hampton Roads,190,4247000,22352.63157894737,104,2755000,26490.384615384617,86,1492000
2017,county,48029,Bexar,06115,Yuba,CA,Sacramento,93,1817000,19537.63440860215,67,1255000,18731.34328358209,26,562000
2017,county,48029,Bexar,48507,Zavala,TX,Rural Texas,121,2336000,19305.785123966944,50,625000,12500.0,71,1711000
2017,total,48491,Williamson,96000,,,,64284,2262460000,35194.76074917553,45093,1562347000,34647.217971747275,19191,700113000
2017,total,48453,Travis,96000,,,,103788,4382171000,42222.3282074999,116153,4147160000,35704.28658751819,-12365,235011000
2017,total,48209,Hays,96000,,,,24645,823777000,33425.72529924934,17340,529734000,30549.826989619378,7305,294043000
2017,total,48091,Comal,96000,,,,20424,808151000,39568.69369369369,11342,373863000,32962.704990301536,9082,434288000
2017,total,48029,Bexar,96000,,,,107120,2959722000,27629.96639283047,99240,2993917000,30168.450221684805,7880,-34195000
2018,county,48453,Travis,16001,Ada,ID,Rural Idaho,71,2691000,37901.40845070423,80,2979000,37237.5,-9,-288000
2018,county,48029,Bexar,16001,Ada,ID,Rural Idaho,46,1029000,22369.565217391304,80,2058000,25725.0,-34,-1029000
2018,county,48453,Travis,08001,Adams,CO,Denver,67,1832000,27343.283582089553,72,2433000,33791.666666666664,-5,-601000
2018,county,48029,Bexar,08001,Adams,CO,Denver,149,3410000,22885.906040268455,91,2880000,31648.351648351647,58,530000
2018,county,48453,Travis,12001,Alachua,FL,Rural Florida,56,1687000,30125.0,50,1609000,32180.0,6,78000
2018,county,48491,Williamson,06001,Alameda,CA,Bay Area,279,15328000,54939.068100358425,62,3050000,49193.54838709677,217,12278000
2018,county,48453,Travis,06001,Alameda,CA,Bay Area,543,39527000,72793.73848987109,294,15124000,51442.1768707483,249,24403000
2018,county,48029,Bexar,06001,Alameda,CA,Bay Area,159,7007000,44069.18238993711,113,3618000,32017.699115044248,46,3389000
2018,county,48453,Travis,51510,Alexandria city,VA,D.C.,63,3847000,61063.49206349206,53,3327000,62773.58490566038,10,520000
2018,county,48029,Bexar,51510,Alexandria city,VA,D.C.,54,3953000,73203.70370370371,63,3715000,58968.25396825397,-9,238000
2018,county,48453,Travis,42003,Allegheny,PA,Pittsburgh,155,7845000,50612.903225806454,100,5977000,59770.0,55,1868000
2018,county,48029,Bexar,42003,Allegheny,PA,Pittsburgh,83,2738000,32987.951807228914,75,2667000,35560.0,8,71000
2018,county,48453,Travis,02020,Anchorage Borough,AK,Rural Alaska,62,2479000,39983.87096774193,42,1176000,28000.0,20,1303000
2018,county,48029,Bexar,02020,Anchorage Borough,AK,Rural Alaska,212,5327000,25127.35849056604,160,5218000,32612.5,52,109000
2018,county,48453,Travis,24003,Anne Arundel,MD,Baltimore,72,4552000,63222.22222222222,38,934000,24578.947368421053,34,3618000
2018,county,48029,Bexar,24003,Anne Arundel,MD,Baltimore,319,10270000,32194.35736677116,272,8563000,31481.617647058825,47,1707000
2018,county,48453,Travis,48007,Aransas,TX,Rural Texas,52,2349000,45173.07692307692,52,1712000,32923.07692307692,0,637000
2018,county,48029,Bexar,48007,Aransas,TX,Rural Texas,144,4489000,31173.61111111111,96,3232000,33666.666666666664,48,1257000
2018,county,48491,Williamson,08005,Arapahoe,CO,Denver,67,2509000,37447.76119402985,44,2159000,49068.181818181816,23,350000
2018,county,48453,Travis,08005,Arapahoe,CO,Denver,166,10286000,61963.85542168675,155,9192000,59303.22580645161,11,1094000
2018,county,48029,Bexar,08005,Arapahoe,CO,Denver,219,6793000,31018.26484018265,232,7530000,32456.896551724138,-13,-737000
2018,county,48453,Travis,51013,Arlington,VA,D.C.,112,11196000,99964.28571428571,68,3230000,47500.0,44,7966000
2018,county,48029,Bexar,51013,Arlington,VA,D.C.,95,6600000,69473.68421052632,79,4272000,54075.94936708861,16,2328000
2018,county,48029,Bexar,48013,Atascosa,TX,Rural Texas,1248,22567000,18082.53205128205,1774,31282000,17633.596392333708,-526,-8715000
2018,county,48453,Travis,24005,Baltimore,MD,Baltimore,82,8823000,107597.56097560975,35,1550000,44285.71428571428,47,7273000
2018,county,48453,Travis,24510,Baltimore city,MD,Baltimore,81,8809000,108753.08641975309,69,2762000,40028.985507246376,12,6047000
2018,county,48029,Bexar,24510,Baltimore city,MD,Baltimore,53,2080000,39245.28301886792,42,1497000,35642.857142857145,11,583000
2018,county,48029,Bexar,48019,Bandera,TX,Rural Texas,415,10588000,25513.253012048193,578,18192000,31474.048442906573,-163,-7604000
2018,county,48491,Williamson,48021,Bastrop,TX,Austin,456,11138000,24425.43859649123,575,12732000,22142.608695652172,-119,-1594000
2018,county,48453,Travis,48021,Bastrop,TX,Austin,1652,38977000,23593.825665859564,3196,63355000,19823.216520650814,-1544,-24378000
2018,county,48209,Hays,48021,Bastrop,TX,Austin,245,5657000,23089.79591836735,301,7558000,25109.634551495015,-56,-1901000
2018,county,48029,Bexar,48021,Bastrop,TX,Austin,110,1884000,17127.272727272728,131,2206000,16839.69465648855,-21,-322000
2018,county,48029,Bexar,48025,Bee,TX,Rural Texas,109,1848000,16954.128440366974,84,1554000,18500.0,25,294000
2018,county,48491,Williamson,48027,Bell,TX,Rural Texas,1586,41371000,26085.11979823455,1716,40441000,23567.016317016318,-130,930000
2018,county,48453,Travis,48027,Bell,TX,Rural Texas,1115,25412000,22791.03139013453,1556,29234000,18787.917737789205,-441,-3822000
2018,county,48209,Hays,48027,Bell,TX,Rural Texas,157,3084000,19643.31210191083,166,3080000,18554.21686746988,-9,4000
2018,county,48091,Comal,48027,Bell,TX,Rural Texas,85,2658000,31270.58823529412,59,1356000,22983.050847457627,26,1302000
2018,county,48029,Bexar,48027,Bell,TX,Rural Texas,1067,21672000,20311.152764761013,825,15348000,18603.636363636364,242,6324000
2018,county,48453,Travis,05007,Benton,AR,Rural Arkansas,76,7028000,92473.68421052632,51,2561000,50215.686274509804,25,4467000
2018,county,48029,Bexar,45015,Berkeley,SC,Charleston,40,813000,20325.0,57,1301000,22824.56140350877,-17,-488000
2018,county,48491,Williamson,35001,Bernalillo,NM,Albuquerque,103,3106000,30155.339805825242,55,2017000,36672.72727272727,48,1089000
2018,county,48453,Travis,35001,Bernalillo,NM,Albuquerque,183,8470000,46284.15300546448,145,4804000,33131.03448275862,38,3666000
2018,county,48029,Bexar,35001,Bernalillo,NM,Albuquerque,290,8227000,28368.96551724138,197,4924000,24994.92385786802,93,3303000
2018,county,48491,Williamson,48029,Bexar,TX,San Antonio,948,28860000,30443.037974683546,754,23154000,30708.222811671087,194,5706000
2018,county,48453,Travis,48029,Bexar,TX,San Antonio,2694,99955000,37102.82108389013,2265,71701000,31656.0706401766,429,28254000
2018,county,48209,Hays,48029,Bexar,TX,San Antonio,666,21605000,32439.93993993994,760,20218000,26602.63157894737,-94,1387000
2018,county,48091,Comal,48029,Bexar,TX,San Antonio,4096,161859000,39516.357421875,2046,71832000,35108.50439882698,2050,90027000
2018,county,48453,Travis,48031,Blanco,TX,Rural Texas,73,3419000,46835.61643835616,126,12530000,99444.44444444444,-53,-9111000
2018,county,48209,Hays,48031,Blanco,TX,Rural Texas,45,694000,15422.222222222223,123,4907000,39894.30894308943,-78,-4213000
2018,county,48091,Comal,48031,Blanco,TX,Rural Texas,72,1891000,26263.88888888889,103,3128000,30368.93203883495,-31,-1237000
2018,county,48029,Bexar,48031,Blanco,TX,Rural Texas,79,1600000,20253.164556962027,66,2316000,35090.90909090909,13,-716000
2018,county,48029,Bexar,22015,Bossier Parish,LA,Rural Louisiana,131,3657000,27916.030534351146,69,2170000,31449.27536231884,62,1487000
2018,county,48453,Travis,08013,Boulder,CO,Denver,114,6520000,57192.98245614035,167,11430000,68443.1137724551,-53,-4910000
2018,county,48029,Bexar,08013,Boulder,CO,Denver,42,993000,23642.85714285714,53,2149000,40547.16981132075,-11,-1156000
2018,county,48491,Williamson,48039,Brazoria,TX,Houston,157,4716000,30038.216560509554,67,2208000,32955.22388059701,90,2508000
2018,county,48453,Travis,48039,Brazoria,TX,Houston,208,7684000,36942.307692307695,162,5309000,32771.60493827161,46,2375000
2018,county,48209,Hays,48039,Brazoria,TX,Houston,68,2229000,32779.41176470588,45,1175000,26111.11111111111,23,1054000
2018,county,48091,Comal,48039,Brazoria,TX,Houston,101,4292000,42495.0495049505,40,1533000,38325.0,61,2759000
2018,county,48029,Bexar,48039,Brazoria,TX,Houston,230,7053000,30665.217391304348,239,6035000,25251.046025104602,-9,1018000
2018,county,48491,Williamson,48041,Brazos,TX,Rural Texas,261,8177000,31329.501915708814,171,5421000,31701.754385964912,90,2756000
2018,county,48453,Travis,48041,Brazos,TX,Rural Texas,444,30938000,69680.18018018018,257,8031000,31249.027237354087,187,22907000
2018,county,48209,Hays,48041,Brazos,TX,Rural Texas,111,3132000,28216.216216216217,72,2208000,30666.666666666668,39,924000
2018,county,48091,Comal,48041,Brazos,TX,Rural Texas,58,1792000,30896.55172413793,62,1700000,27419.354838709678,-4,92000
2018,county,48029,Bexar,48041,Brazos,TX,Rural Texas,312,8321000,26669.871794871793,286,7493000,26199.3006993007,26,828000
2018,county,48453,Travis,12009,Brevard,FL,Atlantic Coast,61,1684000,27606.55737704918,57,2781000,48789.47368421053,4,-1097000
2018,county,48029,Bexar,12009,Brevard,FL,Atlantic Coast,138,3385000,24528.985507246376,117,3540000,30256.410256410258,21,-155000
2018,county,48453,Travis,36005,Bronx,NY,New York,68,1897000,27897.058823529413,127,1484000,11685.03937007874,-59,413000
2018,county,48029,Bexar,36005,Bronx,NY,New York,49,972000,19836.73469387755,34,728000,21411.764705882353,15,244000
2018,county,48491,Williamson,12011,Broward,FL,Miami,130,4273000,32869.230769230766,58,2381000,41051.724137931036,72,1892000
2018,county,48453,Travis,12011,Broward,FL,Miami,276,11634000,42152.17391304348,309,8124000,26291.26213592233,-33,3510000
2018,county,48029,Bexar,12011,Broward,FL,Miami,204,4869000,23867.647058823528,162,8241000,50870.37037037037,42,-3372000
2018,county,48453,Travis,48049,Brown,TX,Rural Texas,45,892000,19822.222222222223,37,1368000,36972.97297297297,8,-476000
2018,county,48453,Travis,42017,Bucks,PA,Philadelphia,48,2379000,49562.5,38,1781000,46868.42105263158,10,598000
2018,county,48453,Travis,37021,Buncombe,NC,Asheville,48,2274000,47375.0,70,4949000,70700.0,-22,-2675000
2018,county,48029,Bexar,34005,Burlington,NJ,Philadelphia,117,2882000,24632.478632478633,71,2195000,30915.49295774648,46,687000
2018,county,48491,Williamson,48053,Burnet,TX,Rural Texas,380,9872000,25978.947368421053,618,23408000,37877.02265372168,-238,-13536000
2018,county,48453,Travis,48053,Burnet,TX,Rural Texas,388,21861000,56342.78350515464,637,26109000,40987.44113029827,-249,-4248000
2018,county,48209,Hays,48053,Burnet,TX,Rural Texas,49,2288000,46693.87755102041,87,2716000,31218.3908045977,-38,-428000
2018,county,48029,Bexar,48053,Burnet,TX,Rural Texas,67,2761000,41208.9552238806,91,5496000,60395.604395604394,-24,-2735000
2018,county,48029,Bexar,22017,Caddo Parish,LA,Rural Louisiana,73,1574000,21561.64383561644,63,1114000,17682.539682539682,10,460000
2018,county,48453,Travis,22019,Calcasieu Parish,LA,Rural Louisiana,36,937000,26027.777777777777,40,721000,18025.0,-4,216000
2018,county,48491,Williamson,48055,Caldwell,TX,Rural Texas,85,2127000,25023.529411764706,132,2616000,19818.18181818182,-47,-489000
2018,county,48453,Travis,48055,Caldwell,TX,Rural Texas,489,8409000,17196.31901840491,1264,19528000,15449.367088607594,-775,-11119000
2018,county,48209,Hays,48055,Caldwell,TX,Rural Texas,744,14123000,18982.52688172043,726,13446000,18520.661157024795,18,677000
2018,county,48029,Bexar,48055,Caldwell,TX,Rural Texas,81,2095000,25864.197530864196,109,2937000,26944.954128440368,-28,-842000
2018,county,48491,Williamson,48061,Cameron,TX,Rural Texas,159,4024000,25308.17610062893,122,3336000,27344.262295081968,37,688000
2018,county,48453,Travis,48061,Cameron,TX,Rural Texas,429,10746000,25048.95104895105,243,5824000,23967.078189300413,186,4922000
2018,county,48209,Hays,48061,Cameron,TX,Rural Texas,123,1709000,13894.30894308943,44,1482000,33681.818181818184,79,227000
2018,county,48029,Bexar,48061,Cameron,TX,Rural Texas,1088,22863000,21013.78676470588,571,11878000,20802.101576182136,517,10985000
2018,county,48453,Travis,45019,Charleston,SC,Charleston,81,3068000,37876.543209876545,53,2546000,48037.735849056604,28,522000
2018,county,48029,Bexar,45019,Charleston,SC,Charleston,69,1506000,21826.08695652174,67,2374000,35432.835820895525,2,-868000
2018,county,48453,Travis,13051,Chatham,GA,Savannah,27,867000,32111.11111111111,59,1372000,23254.237288135595,-32,-505000
2018,county,48029,Bexar,13051,Chatham,GA,Savannah,69,1365000,19782.608695652172,41,984000,24000.0,28,381000
2018,county,48029,Bexar,51550,Chesapeake city,VA,Hampton Roads,67,1699000,25358.20895522388,72,1499000,20819.444444444445,-5,200000
2018,county,48453,Travis,41005,Clackamas,OR,Portland,57,2483000,43561.40350877193,45,1977000,43933.333333333336,12,506000
2018,county,48491,Williamson,32003,Clark,NV,Las Vegas,179,7066000,39474.86033519553,81,2609000,32209.876543209877,98,4457000
2018,county,48453,Travis,32003,Clark,NV,Las Vegas,302,9626000,31874.172185430463,355,13522000,38090.140845070426,-53,-3896000
2018,county,48453,Travis,53011,Clark,WA,Portland,70,4234000,60485.71428571428,90,3685000,40944.444444444445,-20,549000
2018,county,48029,Bexar,32003,Clark,NV,Las Vegas,558,14331000,25682.795698924732,575,15559000,27059.130434782608,-17,-1228000
2018,county,48029,Bexar,53011,Clark,WA,Portland,76,3753000,49381.57894736842,84,1937000,23059.52380952381,-8,1816000
2018,county,48453,Travis,40027,Cleveland,OK,Oklahoma City,75,2195000,29266.666666666668,41,1526000,37219.51219512195,34,669000
2018,county,48029,Bexar,40027,Cleveland,OK,Oklahoma City,102,2392000,23450.980392156864,47,1115000,23723.40425531915,55,1277000
2018,county,48453,Travis,13067,Cobb,GA,Atlanta,141,6375000,45212.765957446805,134,4486000,33477.611940298506,7,1889000
2018,county,48029,Bexar,13067,Cobb,GA,Atlanta,77,1849000,24012.987012987014,117,3302000,28222.222222222223,-40,-1453000
2018,county,48029,Bexar,04003,Cochise,AZ,Rural Arizona,91,2303000,25307.69230769231,74,1821000,24608.108108108107,17,482000
2018,county,48453,Travis,12021,Collier,FL,S.W. Florida,57,5160000,90526.31578947368,50,2641000,52820.0,7,2519000
2018,county,48029,Bexar,12021,Collier,FL,S.W. Florida,37,729000,19702.702702702703,41,1707000,41634.14634146341,-4,-978000
2018,county,48491,Williamson,48085,Collin,TX,Dallas-Fort Worth,468,22080000,47179.48717948718,428,17601000,41123.831775700935,40,4479000
2018,county,48453,Travis,48085,Collin,TX,Dallas-Fort Worth,841,42541000,50583.82877526754,727,34993000,48133.425034387896,114,7548000
2018,county,48209,Hays,48085,Collin,TX,Dallas-Fort Worth,117,4785000,40897.4358974359,100,2784000,27840.0,17,2001000
2018,county,48091,Comal,48085,Collin,TX,Dallas-Fort Worth,144,8037000,55812.5,39,1745000,44743.58974358974,105,6292000
2018,county,48029,Bexar,48085,Collin,TX,Dallas-Fort Worth,508,16837000,33143.700787401576,807,29583000,36657.99256505576,-299,-12746000
2018,county,48029,Bexar,13073,Columbia,GA,Augusta,164,4592000,28000.0,133,2951000,22187.96992481203,31,1641000
2018,county,48491,Williamson,48091,Comal,TX,San Antonio,136,4871000,35816.17647058824,224,8005000,35736.607142857145,-88,-3134000
2018,county,48453,Travis,48091,Comal,TX,San Antonio,328,11656000,35536.58536585366,480,27174000,56612.5,-152,-15518000
2018,county,48209,Hays,48091,Comal,TX,San Antonio,494,26928000,54510.12145748988,907,27223000,30014.332965821388,-413,-295000
2018,county,48029,Bexar,48091,Comal,TX,San Antonio,2046,71832000,35108.50439882698,4096,161859000,39516.357421875,-2050,-90027000
2018,county,48029,Bexar,40031,Comanche,OK,Rural Oklahoma,126,2434000,19317.460317460318,79,1479000,18721.518987341773,47,955000
2018,county,48453,Travis,06013,Contra Costa,CA,Bay Area,314,22752000,72458.59872611465,119,11740000,98655.46218487395,195,11012000
2018,county,48029,Bexar,06013,Contra Costa,CA,Bay Area,128,5341000,41726.5625,56,1955000,34910.71428571428,72,3386000
2018,county,48491,Williamson,17031,Cook,IL,Chicago,303,13410000,44257.425742574254,90,3387000,37633.333333333336,213,10023000
2018,county,48453,Travis,17031,Cook,IL,Chicago,915,60374000,65982.51366120219,650,28672000,44110.769230769234,265,31702000
2018,county,48209,Hays,17031,Cook,IL,Chicago,69,3255000,47173.913043478264,29,1002000,34551.724137931036,40,2253000
2018,county,48029,Bexar,17031,Cook,IL,Chicago,533,20385000,38245.77861163227,398,19955000,50138.19095477387,135,430000
2018,county,48491,Williamson,48099,Coryell,TX,Rural Texas,206,4386000,21291.26213592233,161,3230000,20062.111801242238,45,1156000
2018,county,48453,Travis,48099,Coryell,TX,Rural Texas,153,2826000,18470.58823529412,180,3242000,18011.11111111111,-27,-416000
2018,county,48029,Bexar,48099,Coryell,TX,Rural Texas,182,2922000,16054.945054945056,107,1562000,14598.130841121496,75,1360000
2018,county,48453,Travis,37051,Cumberland,NC,Rural North Carolina,37,972000,26270.27027027027,44,595000,13522.727272727272,-7,377000
2018,county,48029,Bexar,37051,Cumberland,NC,Rural North Carolina,314,6061000,19302.547770700636,261,5134000,19670.498084291186,53,927000
2018,county,48029,Bexar,35009,Curry,NM,Rural New Mexico,103,1910000,18543.68932038835,93,1756000,18881.720430107525,10,154000
2018,county,48453,Travis,39035,Cuyahoga,OH,Cleveland,107,4144000,38728.97196261682,128,2426000,18953.125,-21,1718000
2018,county,48029,Bexar,39035,Cuyahoga,OH,Cleveland,75,3366000,44880.0,58,2209000,38086.206896551725,17,1157000
2018,county,48491,Williamson,48113,Dallas,TX,Dallas-Fort Worth,609,24017000,39436.7816091954,496,18389000,37074.596774193546,113,5628000
2018,county,48453,Travis,48113,Dallas,TX,Dallas-Fort Worth,2049,124475000,60749.14592484139,1826,93801000,51369.66046002191,223,30674000
2018,county,48209,Hays,48113,Dallas,TX,Dallas-Fort Worth,192,9791000,50994.791666666664,142,4184000,29464.788732394365,50,5607000
2018,county,48091,Comal,48113,Dallas,TX,Dallas-Fort Worth,115,7578000,65895.65217391304,91,4298000,47230.769230769234,24,3280000
2018,county,48029,Bexar,48113,Dallas,TX,Dallas-Fort Worth,1331,44960000,33779.11344853494,1555,53897000,34660.4501607717,-224,-8937000
2018,county,48453,Travis,55025,Dane,WI,Madison,131,7712000,58870.229007633585,67,2901000,43298.50746268657,64,4811000
2018,county,48029,Bexar,55025,Dane,WI,Madison,69,2461000,35666.666666666664,40,2173000,54325.0,29,288000
2018,county,48491,Williamson,47037,Davidson,TN,Nashville,57,2702000,47403.508771929824,39,1099000,28179.48717948718,18,1603000
2018,county,48453,Travis,47037,Davidson,TN,Nashville,171,9095000,53187.134502923975,206,8823000,42830.09708737864,-35,272000
2018,county,48029,Bexar,47037,Davidson,TN,Nashville,79,1991000,25202.53164556962,106,3767000,35537.735849056604,-27,-1776000
2018,county,48029,Bexar,49011,Davis,UT,Rural Utah,154,3914000,25415.584415584417,78,2131000,27320.51282051282,76,1783000
2018,county,48453,Travis,13089,DeKalb,GA,Atlanta,90,3318000,36866.666666666664,166,6271000,37777.10843373494,-76,-2953000
2018,county,48029,Bexar,13089,DeKalb,GA,Atlanta,69,2047000,29666.666666666668,77,2283000,29649.35064935065,-8,-236000
2018,county,48029,Bexar,48123,DeWitt,TX,Rural Texas,70,1415000,20214.285714285714,44,1092000,24818.18181818182,26,323000
2018,county,48453,Travis,42045,Delaware,PA,Philadelphia,29,2400000,82758.62068965517,33,903000,27363.636363636364,-4,1497000
2018,county,48491,Williamson,48121,Denton,TX,Dallas-Fort Worth,347,14823000,42717.57925072046,302,11453000,37923.84105960265,45,3370000
2018,county,48453,Travis,48121,Denton,TX,Dallas-Fort Worth,643,22343000,34748.05598755832,647,22724000,35122.10200927357,-4,-381000
2018,county,48209,Hays,48121,Denton,TX,Dallas-Fort Worth,107,4076000,38093.457943925234,110,3883000,35300.0,-3,193000
2018,county,48091,Comal,48121,Denton,TX,Dallas-Fort Worth,67,3483000,51985.07462686567,49,1597000,32591.836734693876,18,1886000
2018,county,48029,Bexar,48121,Denton,TX,Dallas-Fort Worth,419,14827000,35386.634844868735,580,19402000,33451.724137931036,-161,-4575000
2018,county,48491,Williamson,08031,Denver,CO,Denver,60,2495000,41583.333333333336,56,2989000,53375.0,4,-494000
2018,county,48453,Travis,08031,Denver,CO,Denver,244,13916000,57032.7868852459,411,22591000,54965.936739659366,-167,-8675000
2018,county,48029,Bexar,08031,Denver,CO,Denver,136,5097000,37477.94117647059,179,8776000,49027.93296089386,-43,-3679000
2018,county,48453,Travis,41017,Deschutes,OR,Rural Oregon,56,1697000,30303.571428571428,59,3139000,53203.38983050847,-3,-1442000
2018,county,48029,Bexar,48127,Dimmit,TX,Rural Texas,79,2178000,27569.620253164558,52,1232000,23692.30769230769,27,946000
2018,county,48453,Travis,11001,District of Columbia,DC,D.C.,292,23120000,79178.08219178082,212,11388000,53716.981132075474,80,11732000
2018,county,48029,Bexar,11001,District of Columbia,DC,D.C.,119,7530000,63277.31092436975,104,5652000,54346.153846153844,15,1878000
2018,county,48453,Travis,35013,Dona Ana,NM,Rural New Mexico,70,1718000,24542.85714285714,36,1087000,30194.444444444445,34,631000
2018,county,48029,Bexar,35013,Dona Ana,NM,Rural New Mexico,117,2890000,24700.8547008547,78,1826000,23410.25641025641,39,1064000
2018,county,48491,Williamson,08035,Douglas,CO,Denver,63,3857000,61222.22222222222,81,3698000,45654.32098765432,-18,159000
2018,county,48453,Travis,08035,Douglas,CO,Denver,93,5238000,56322.58064516129,117,5294000,45247.86324786325,-24,-56000
2018,county,48453,Travis,31055,Douglas,NE,Omaha,81,4244000,52395.06172839506,67,3072000,45850.746268656716,14,1172000
2018,county,48029,Bexar,31055,Douglas,NE,Omaha,94,3854000,41000.0,73,2104000,28821.91780821918,21,1750000
2018,county,48029,Bexar,08035,Douglas,CO,Denver,66,2528000,38303.030303030304,161,8959000,55645.96273291925,-95,-6431000
2018,county,48453,Travis,17043,DuPage,IL,Chicago,162,9503000,58660.49382716049,80,3139000,39237.5,82,6364000
2018,county,48029,Bexar,17043,DuPage,IL,Chicago,111,3240000,29189.18918918919,90,3970000,44111.11111111111,21,-730000
2018,county,48453,Travis,37063,Durham,NC,Raleigh,73,3141000,43027.397260273974,88,3460000,39318.181818181816,-15,-319000
2018,county,48453,Travis,12031,Duval,FL,Jacksonville,128,4684000,36593.75,132,3178000,24075.757575757576,-4,1506000
2018,county,48029,Bexar,12031,Duval,FL,Jacksonville,174,5492000,31563.2183908046,181,5150000,28453.03867403315,-7,342000
2018,county,48453,Travis,22033,East Baton Rouge Parish,LA,Rural Louisiana,129,4907000,38038.75968992248,73,1845000,25273.972602739726,56,3062000
2018,county,48029,Bexar,22033,East Baton Rouge Parish,LA,Rural Louisiana,95,3350000,35263.15789473684,61,1275000,20901.639344262294,34,2075000
2018,county,48491,Williamson,48135,Ector,TX,Rural Texas,104,3707000,35644.230769230766,32,1367000,42718.75,72,2340000
2018,county,48453,Travis,48135,Ector,TX,Rural Texas,95,3356000,35326.31578947369,85,2192000,25788.235294117647,10,1164000
2018,county,48029,Bexar,48135,Ector,TX,Rural Texas,240,8478000,35325.0,268,6569000,24511.194029850747,-28,1909000
2018,county,48491,Williamson,48141,El Paso,TX,El Paso,270,6754000,25014.814814814814,185,4469000,24156.756756756757,85,2285000
2018,county,48491,Williamson,08041,El Paso,CO,Colorado Springs,125,3443000,27544.0,106,4157000,39216.981132075474,19,-714000
2018,county,48453,Travis,48141,El Paso,TX,El Paso,496,15080000,30403.225806451614,426,11571000,27161.971830985916,70,3509000
2018,county,48453,Travis,08041,El Paso,CO,Colorado Springs,182,6365000,34972.52747252747,217,7374000,33981.5668202765,-35,-1009000
2018,county,48209,Hays,48141,El Paso,TX,El Paso,75,1431000,19080.0,51,1271000,24921.56862745098,24,160000
2018,county,48091,Comal,48141,El Paso,TX,El Paso,59,2348000,39796.61016949153,44,688000,15636.363636363636,15,1660000
2018,county,48029,Bexar,48141,El Paso,TX,El Paso,1485,33159000,22329.29292929293,964,21248000,22041.49377593361,521,11911000
2018,county,48029,Bexar,08041,El Paso,CO,Colorado Springs,697,16388000,23512.19512195122,758,21582000,28472.295514511872,-61,-5194000
2018,county,48491,Williamson,48139,Ellis,TX,Dallas-Fort Worth,53,2137000,40320.75471698113,37,1212000,32756.756756756757,16,925000
2018,county,48453,Travis,48139,Ellis,TX,Dallas-Fort Worth,65,2363000,36353.846153846156,62,2331000,37596.77419354839,3,32000
2018,county,48029,Bexar,48139,Ellis,TX,Dallas-Fort Worth,67,1942000,28985.074626865673,89,2771000,31134.83146067416,-22,-829000
2018,county,48453,Travis,36029,Erie,NY,Buffalo,65,2602000,40030.769230769234,67,834000,12447.76119402985,-2,1768000
2018,county,48029,Bexar,36029,Erie,NY,Buffalo,61,2133000,34967.2131147541,70,3312000,47314.28571428572,-9,-1179000
2018,county,48453,Travis,12033,Escambia,FL,FL Panhandle,49,1553000,31693.877551020407,46,1347000,29282.608695652172,3,206000
2018,county,48029,Bexar,12033,Escambia,FL,FL Panhandle,170,6009000,35347.05882352941,162,3166000,19543.20987654321,8,2843000
2018,county,48453,Travis,25009,Essex,MA,Boston,56,2349000,41946.42857142857,69,3367000,48797.10144927536,-13,-1018000
2018,county,48453,Travis,34013,Essex,NJ,New York,68,8669000,127485.29411764706,35,1226000,35028.57142857143,33,7443000
2018,county,48029,Bexar,02090,Fairbanks North Star Borough,AK,Rural Alaska,113,2309000,20433.62831858407,95,1843000,19400.0,18,466000
2018,county,48491,Williamson,51059,Fairfax,VA,D.C.,110,5677000,51609.09090909091,71,2150000,30281.690140845072,39,3527000
2018,county,48453,Travis,51059,Fairfax,VA,D.C.,283,14868000,52537.102473498235,160,7383000,46143.75,123,7485000
2018,county,48029,Bexar,51059,Fairfax,VA,D.C.,435,17701000,40691.9540229885,428,14845000,34684.57943925234,7,2856000
2018,county,48453,Travis,09001,Fairfield,CT,New York,178,10575000,59410.11235955056,84,4291000,51083.333333333336,94,6284000
2018,county,48453,Travis,48149,Fayette,TX,Rural Texas,48,1555000,32395.833333333332,56,1842000,32892.857142857145,-8,-287000
2018,county,48453,Travis,21067,Fayette,KY,Lexington,69,-322300000,-4671014.492753623,36,1666000,46277.77777777778,33,-323966000
2018,county,48029,Bexar,37067,Forsyth,NC,Greensboro,39,1104000,28307.69230769231,41,1254000,30585.365853658535,-2,-150000
2018,county,48491,Williamson,48157,Fort Bend,TX,Houston,309,13442000,43501.61812297734,188,7545000,40132.97872340425,121,5897000
2018,county,48453,Travis,48157,Fort Bend,TX,Houston,726,39600000,54545.454545454544,494,20315000,41123.48178137652,232,19285000
2018,county,48209,Hays,48157,Fort Bend,TX,Houston,127,7116000,56031.496062992126,83,2226000,26819.277108433736,44,4890000
2018,county,48091,Comal,48157,Fort Bend,TX,Houston,132,9105000,68977.27272727272,60,2321000,38683.333333333336,72,6784000
2018,county,48029,Bexar,48157,Fort Bend,TX,Houston,524,19457000,37131.67938931298,565,20462000,36215.929203539825,-41,-1005000
2018,county,48453,Travis,39049,Franklin,OH,Columbus,174,7784000,44735.63218390805,161,5226000,32459.627329192546,13,2558000
2018,county,48029,Bexar,39049,Franklin,OH,Columbus,160,4524000,28275.0,162,4289000,26475.30864197531,-2,235000
2018,county,48453,Travis,06019,Fresno,CA,Fresno,74,2330000,31486.486486486487,55,1086000,19745.454545454544,19,1244000
2018,county,48029,Bexar,06019,Fresno,CA,Fresno,82,1988000,24243.90243902439,62,1096000,17677.41935483871,20,892000
2018,county,48029,Bexar,48163,Frio,TX,Rural Texas,197,5642000,28639.593908629442,172,3191000,18552.325581395347,25,2451000
2018,county,48453,Travis,13121,Fulton,GA,Atlanta,222,14900000,67117.11711711712,292,29695000,101695.20547945205,-70,-14795000
2018,county,48029,Bexar,13121,Fulton,GA,Atlanta,102,3728000,36549.01960784314,133,4359000,32774.436090225565,-31,-631000
2018,county,48491,Williamson,48167,Galveston,TX,Houston,154,5735000,37240.25974025974,111,3308000,29801.8018018018,43,2427000
2018,county,48453,Travis,48167,Galveston,TX,Houston,273,15941000,58391.94139194139,210,7853000,37395.23809523809,63,8088000
2018,county,48209,Hays,48167,Galveston,TX,Houston,86,3462000,40255.813953488374,39,1404000,36000.0,47,2058000
2018,county,48091,Comal,48167,Galveston,TX,Houston,94,5698000,60617.02127659575,39,1383000,35461.53846153846,55,4315000
2018,county,48029,Bexar,48167,Galveston,TX,Houston,249,7897000,31714.859437751005,220,7041000,32004.545454545456,29,856000
2018,county,48029,Bexar,20061,Geary,KS,Rural Kansas,132,1900000,14393.939393939394,106,1753000,16537.735849056604,26,147000
2018,county,48453,Travis,48171,Gillespie,TX,Rural Texas,62,2903000,46822.58064516129,97,7190000,74123.71134020618,-35,-4287000
2018,county,48029,Bexar,48171,Gillespie,TX,Rural Texas,144,3986000,27680.555555555555,116,7062000,60879.31034482759,28,-3076000
2018,county,48453,Travis,48177,Gonzales,TX,Rural Texas,46,1208000,26260.869565217392,57,970000,17017.543859649122,-11,238000
2018,county,48029,Bexar,48177,Gonzales,TX,Rural Texas,74,1177000,15905.405405405405,77,1295000,16818.18181818182,-3,-118000
2018,county,48029,Bexar,38035,Grand Forks,ND,Rural North Dakota,46,882000,19173.91304347826,30,919000,30633.333333333332,16,-37000
2018,county,48453,Travis,48181,Grayson,TX,Rural Texas,36,1086000,30166.666666666668,48,1255000,26145.833333333332,-12,-169000
2018,county,48029,Bexar,39057,Greene,OH,Rural Ohio,73,2546000,34876.71232876712,151,4030000,26688.741721854305,-78,-1484000
2018,county,48453,Travis,48183,Gregg,TX,Rural Texas,58,2896000,49931.03448275862,55,1698000,30872.727272727272,3,1198000
2018,county,48029,Bexar,48183,Gregg,TX,Rural Texas,62,1806000,29129.032258064515,35,1175000,33571.42857142857,27,631000
2018,county,48491,Williamson,48187,Guadalupe,TX,San Antonio,127,4428000,34866.14173228347,122,3916000,32098.360655737706,5,512000
2018,county,48453,Travis,48187,Guadalupe,TX,San Antonio,257,7166000,27883.26848249027,321,8633000,26894.080996884735,-64,-1467000
2018,county,48209,Hays,48187,Guadalupe,TX,San Antonio,639,11147000,17444.444444444445,801,16999000,21222.222222222223,-162,-5852000
2018,county,48091,Comal,48187,Guadalupe,TX,San Antonio,2749,83146000,30245.90760276464,2133,59715000,27995.7805907173,616,23431000
2018,county,48029,Bexar,48187,Guadalupe,TX,San Antonio,3162,83579000,26432.321315623023,5128,149991000,29249.414976599062,-1966,-66412000
2018,county,48453,Travis,37081,Guilford,NC,Greensboro,46,2184000,47478.260869565216,62,1734000,27967.74193548387,-16,450000
2018,county,48453,Travis,13135,Gwinnett,GA,Atlanta,75,3133000,41773.333333333336,105,2689000,25609.52380952381,-30,444000
2018,county,48029,Bexar,13135,Gwinnett,GA,Atlanta,143,2966000,20741.25874125874,95,1908000,20084.21052631579,48,1058000
2018,county,48453,Travis,39061,Hamilton,OH,Cincinnati,80,3371000,42137.5,95,2475000,26052.63157894737,-15,896000
2018,county,48453,Travis,18057,Hamilton,IN,Indianapolis,53,2576000,48603.77358490566,48,2701000,56270.833333333336,5,-125000
2018,county,48029,Bexar,39061,Hamilton,OH,Cincinnati,70,8780000,125428.57142857143,73,1566000,21452.054794520547,-3,7214000
2018,county,48029,Bexar,51650,Hampton city,VA,Hampton Roads,85,1975000,23235.29411764706,69,2048000,29681.159420289856,16,-73000
2018,county,48029,Bexar,21093,Hardin,KY,Louisville,65,1589000,24446.153846153848,64,1603000,25046.875,1,-14000
2018,county,48029,Bexar,37085,Harnett,NC,Rural North Carolina,90,1994000,22155.555555555555,91,2341000,25725.274725274725,-1,-347000
2018,county,48491,Williamson,48201,Harris,TX,Houston,1467,52950000,36094.06952965235,863,29602000,34301.27462340672,604,23348000
2018,county,48453,Travis,48201,Harris,TX,Houston,4240,219802000,51840.09433962264,3092,140840000,45549.80595084088,1148,78962000
2018,county,48209,Hays,48201,Harris,TX,Houston,601,28121000,46790.34941763727,407,9813000,24110.565110565112,194,18308000
2018,county,48091,Comal,48201,Harris,TX,Houston,670,40238000,60056.71641791045,272,9917000,36459.55882352941,398,30321000
2018,county,48029,Bexar,48201,Harris,TX,Houston,3192,99205000,31079.260651629073,2967,91593000,30870.57633973711,225,7612000
2018,county,48029,Bexar,28047,Harrison,MS,Gulfport-Biloxi,200,4088000,20440.0,122,3408000,27934.426229508197,78,680000
2018,county,48453,Travis,09003,Hartford,CT,Hartford,71,5344000,75267.60563380281,66,2226000,33727.27272727273,5,3118000
2018,county,48029,Bexar,09003,Hartford,CT,Hartford,80,2353000,29412.5,46,1077000,23413.043478260868,34,1276000
2018,county,48491,Williamson,48209,Hays,TX,Austin,838,25152000,30014.319809069213,698,22540000,32292.263610315185,140,2612000
2018,county,48453,Travis,48209,Hays,TX,Austin,3853,127096000,32986.24448481703,7592,322788000,42516.85985247629,-3739,-195692000
2018,county,48091,Comal,48209,Hays,TX,Austin,907,27223000,30014.332965821388,494,26928000,54510.12145748988,413,295000
2018,county,48029,Bexar,48209,Hays,TX,Austin,760,20218000,26602.63157894737,666,21605000,32439.93993993994,94,-1387000
2018,county,48491,Williamson,27053,Hennepin,MN,Minneapolis,85,3616000,42541.17647058824,46,2336000,50782.608695652176,39,1280000
2018,county,48453,Travis,27053,Hennepin,MN,Minneapolis,255,16529000,64819.60784313725,185,10628000,57448.64864864865,70,5901000
2018,county,48029,Bexar,27053,Hennepin,MN,Minneapolis,98,3776000,38530.61224489796,146,6678000,45739.72602739726,-48,-2902000
2018,county,48029,Bexar,51087,Henrico,VA,Richmond,47,1291000,27468.08510638298,60,1422000,23700.0,-13,-131000
2018,county,48491,Williamson,48215,Hidalgo,TX,Rural Texas,218,6349000,29123.853211009173,94,2155000,22925.531914893618,124,4194000
2018,county,48453,Travis,48215,Hidalgo,TX,Rural Texas,615,14951000,24310.56910569106,360,10088000,28022.222222222223,255,4863000
2018,county,48209,Hays,48215,Hidalgo,TX,Rural Texas,86,1704000,19813.95348837209,105,2277000,21685.714285714286,-19,-573000
2018,county,48029,Bexar,48215,Hidalgo,TX,Rural Texas,1565,33879000,21647.923322683706,879,18663000,21232.081911262798,686,15216000
2018,county,48491,Williamson,12057,Hillsborough,FL,Tampa,54,1432000,26518.51851851852,67,2097000,31298.507462686568,-13,-665000
2018,county,48453,Travis,12057,Hillsborough,FL,Tampa,239,11376000,47598.32635983264,303,11779000,38874.587458745875,-64,-403000
2018,county,48029,Bexar,12057,Hillsborough,FL,Tampa,262,6123000,23370.22900763359,335,10122000,30214.925373134327,-73,-3999000
2018,county,48453,Travis,28049,Hinds,MS,Jackson,37,897000,24243.243243243243,46,710000,15434.782608695652,-9,187000
2018,county,48491,Williamson,15003,Honolulu,HI,Rural Hawaii,143,3495000,24440.559440559442,49,1374000,28040.816326530614,94,2121000
2018,county,48453,Travis,15003,Honolulu,HI,Rural Hawaii,205,8873000,43282.92682926829,97,4221000,43515.463917525776,108,4652000
2018,county,48029,Bexar,15003,Honolulu,HI,Rural Hawaii,856,22491000,26274.532710280375,485,11681000,24084.536082474227,371,10810000
2018,county,48029,Bexar,48221,Hood,TX,Rural Texas,41,1238000,30195.121951219513,52,2935000,56442.307692307695,-11,-1697000
2018,county,48453,Travis,45051,Horry,SC,Rural South Carolina,31,1535000,49516.12903225807,42,817000,19452.380952380954,-11,718000
2018,county,48029,Bexar,13153,Houston,GA,Rural Georgia,116,2934000,25293.103448275862,61,1489000,24409.83606557377,55,1445000
2018,county,48029,Bexar,24027,Howard,MD,Baltimore,93,3074000,33053.76344086022,83,2778000,33469.87951807229,10,296000
2018,county,48453,Travis,34017,Hudson,NJ,New York,113,8489000,75123.89380530974,75,4002000,53360.0,38,4487000
2018,county,48029,Bexar,34017,Hudson,NJ,New York,48,2749000,57270.833333333336,44,2072000,47090.90909090909,4,677000
2018,county,48029,Bexar,53029,Island,WA,Rural Washington,41,807000,19682.926829268294,41,885000,21585.365853658535,0,-78000
2018,county,48453,Travis,29095,Jackson,MO,Kansas City,105,5223000,49742.857142857145,95,3339000,35147.36842105263,10,1884000
2018,county,48029,Bexar,29095,Jackson,MO,Kansas City,114,4375000,38377.19298245614,81,2192000,27061.728395061727,33,2183000
2018,county,48491,Williamson,48245,Jefferson,TX,Rural Texas,113,2278000,20159.29203539823,36,1080000,30000.0,77,1198000
2018,county,48491,Williamson,08059,Jefferson,CO,Denver,47,4089000,87000.0,62,3324000,53612.903225806454,-15,765000
2018,county,48453,Travis,48245,Jefferson,TX,Rural Texas,231,7520000,32554.112554112555,112,3644000,32535.714285714286,119,3876000
2018,county,48453,Travis,08059,Jefferson,CO,Denver,113,6730000,59557.5221238938,166,7825000,47138.55421686747,-53,-1095000
2018,county,48453,Travis,21111,Jefferson,KY,Louisville,76,3043000,40039.47368421053,74,3377000,45635.13513513513,2,-334000
2018,county,48453,Travis,01073,Jefferson,AL,Birmingham,43,1853000,43093.023255813954,86,2601000,30244.18604651163,-43,-748000
2018,county,48029,Bexar,48245,Jefferson,TX,Rural Texas,159,4873000,30647.798742138366,87,1610000,18505.74712643678,72,3263000
2018,county,48029,Bexar,36045,Jefferson,NY,Rural New York,206,3365000,16334.95145631068,108,2613000,24194.444444444445,98,752000
2018,county,48029,Bexar,08059,Jefferson,CO,Denver,112,3947000,35241.07142857143,93,3056000,32860.215053763444,19,891000
2018,county,48029,Bexar,21111,Jefferson,KY,Louisville,79,2778000,35164.556962025315,52,1835000,35288.46153846154,27,943000
2018,county,48029,Bexar,01073,Jefferson,AL,Birmingham,71,2744000,38647.887323943665,51,3828000,75058.82352941176,20,-1084000
2018,county,48453,Travis,22051,Jefferson Parish,LA,New Orleans,90,2616000,29066.666666666668,89,2091000,23494.38202247191,1,525000
2018,county,48029,Bexar,22051,Jefferson Parish,LA,New Orleans,66,2620000,39696.969696969696,52,1030000,19807.69230769231,14,1590000
2018,county,48029,Bexar,48249,Jim Wells,TX,Rural Texas,234,4574000,19547.008547008547,105,1524000,14514.285714285714,129,3050000
2018,county,48491,Williamson,20091,Johnson,KS,Kansas City,73,2320000,31780.821917808218,56,2417000,43160.71428571428,17,-97000
2018,county,48453,Travis,20091,Johnson,KS,Kansas City,139,12419000,89345.32374100719,64,2849000,44515.625,75,9570000
2018,county,48453,Travis,48251,Johnson,TX,Dallas-Fort Worth,53,1959000,36962.264150943396,56,1127000,20125.0,-3,832000
2018,county,48029,Bexar,20091,Johnson,KS,Kansas City,130,5712000,43938.46153846154,86,4427000,51476.74418604651,44,1285000
2018,county,48029,Bexar,48251,Johnson,TX,Dallas-Fort Worth,61,1672000,27409.83606557377,98,2015000,20561.224489795917,-37,-343000
2018,county,48029,Bexar,48255,Karnes,TX,Rural Texas,109,3204000,29394.495412844037,70,1674000,23914.285714285714,39,1530000
2018,county,48453,Travis,48257,Kaufman,TX,Dallas-Fort Worth,35,943000,26942.85714285714,67,1912000,28537.31343283582,-32,-969000
2018,county,48029,Bexar,48257,Kaufman,TX,Dallas-Fort Worth,50,1608000,32160.0,58,1395000,24051.724137931036,-8,213000
2018,county,48453,Travis,48259,Kendall,TX,Rural Texas,71,3514000,49492.957746478874,86,3616000,42046.51162790698,-15,-102000
2018,county,48091,Comal,48259,Kendall,TX,Rural Texas,192,7476000,38937.5,125,6932000,55456.0,67,544000
2018,county,48029,Bexar,48259,Kendall,TX,Rural Texas,1126,55122000,48953.8188277087,1902,88659000,46613.564668769715,-776,-33537000
2018,county,48453,Travis,26081,Kent,MI,Rural Michigan,61,2319000,38016.39344262295,53,2254000,42528.301886792455,8,65000
2018,county,48029,Bexar,10001,Kent,DE,Rural Delaware,93,2348000,25247.31182795699,41,1126000,27463.414634146342,52,1222000
2018,county,48029,Bexar,26081,Kent,MI,Rural Michigan,46,1046000,22739.130434782608,58,1402000,24172.41379310345,-12,-356000
2018,county,48453,Travis,06029,Kern,CA,Rural California,62,1939000,31274.1935483871,155,1668000,10761.290322580646,-93,271000
2018,county,48029,Bexar,06029,Kern,CA,Rural California,146,2840000,19452.054794520547,102,2501000,24519.607843137255,44,339000
2018,county,48491,Williamson,48265,Kerr,TX,Rural Texas,52,1778000,34192.307692307695,43,1407000,32720.93023255814,9,371000
2018,county,48453,Travis,48265,Kerr,TX,Rural Texas,103,4357000,42300.970873786406,97,3852000,39711.34020618557,6,505000
2018,county,48029,Bexar,48265,Kerr,TX,Rural Texas,338,8516000,25195.26627218935,322,9612000,29850.931677018634,16,-1096000
2018,county,48491,Williamson,53033,King,WA,Seattle,307,16938000,55172.638436482084,194,12044000,62082.47422680412,113,4894000
2018,county,48453,Travis,53033,King,WA,Seattle,637,46082000,72342.22919937206,786,51670000,65737.91348600508,-149,-5588000
2018,county,48029,Bexar,53033,King,WA,Seattle,268,12382000,46201.49253731343,309,13213000,42760.517799352754,-41,-831000
2018,county,48453,Travis,36047,Kings,NY,New York,466,28762000,61721.03004291846,358,17537000,48986.03351955307,108,11225000
2018,county,48029,Bexar,36047,Kings,NY,New York,128,4852000,37906.25,95,2850000,30000.0,33,2002000
2018,county,48453,Travis,53035,Kitsap,WA,Rural Washington,57,2061000,36157.89473684211,55,2527000,45945.454545454544,2,-466000
2018,county,48029,Bexar,53035,Kitsap,WA,Rural Washington,87,1766000,20298.850574712644,82,1677000,20451.219512195123,5,89000
2018,county,48029,Bexar,48273,Kleberg,TX,Rural Texas,141,2877000,20404.255319148935,86,1510000,17558.13953488372,55,1367000
2018,county,48453,Travis,47093,Knox,TN,Knoxville,50,2002000,40040.0,50,1935000,38700.0,0,67000
2018,county,48029,Bexar,47093,Knox,TN,Knoxville,53,2685000,50660.377358490565,50,1890000,37800.0,3,795000
2018,county,48029,Bexar,48283,La Salle,TX,Rural Texas,42,778000,18523.809523809523,48,1282000,26708.333333333332,-6,-504000
2018,county,48453,Travis,22055,Lafayette Parish,LA,Rural Louisiana,74,2273000,30716.216216216217,48,1516000,31583.333333333332,26,757000
2018,county,48029,Bexar,22055,Lafayette Parish,LA,Rural Louisiana,75,1650000,22000.0,52,1191000,22903.846153846152,23,459000
2018,county,48453,Travis,17097,Lake,IL,Chicago,125,12120000,96960.0,91,3992000,43868.131868131866,34,8128000
2018,county,48029,Bexar,17097,Lake,IL,Chicago,88,4326000,49159.09090909091,89,2190000,24606.74157303371,-1,2136000
2018,county,48029,Bexar,18089,Lake,IN,Rural Indiana,62,1043000,16822.58064516129,44,868000,19727.272727272728,18,175000
2018,county,48491,Williamson,48281,Lampasas,TX,Rural Texas,78,1796000,23025.641025641027,153,3898000,25477.124183006537,-75,-2102000
2018,county,48453,Travis,48281,Lampasas,TX,Rural Texas,53,1397000,26358.490566037737,54,2406000,44555.555555555555,-1,-1009000
2018,county,48453,Travis,41039,Lane,OR,Rural Oregon,53,1936000,36528.301886792455,53,1631000,30773.584905660377,0,305000
2018,county,48029,Bexar,56021,Laramie,WY,Rural Wyoming,112,1918000,17125.0,98,1798000,18346.938775510203,14,120000
2018,county,48491,Williamson,08069,Larimer,CO,Rural Colorado,42,2383000,56738.09523809524,50,2044000,40880.0,-8,339000
2018,county,48453,Travis,08069,Larimer,CO,Rural Colorado,102,4817000,47225.490196078434,117,4191000,35820.51282051282,-15,626000
2018,county,48029,Bexar,08069,Larimer,CO,Rural Colorado,56,1474000,26321.428571428572,72,2200000,30555.555555555555,-16,-726000
2018,county,48491,Williamson,48287,Lee,TX,Rural Texas,82,1661000,20256.09756097561,125,3827000,30616.0,-43,-2166000
2018,county,48453,Travis,48287,Lee,TX,Rural Texas,110,2270000,20636.363636363636,108,3659000,33879.62962962963,2,-1389000
2018,county,48453,Travis,12071,Lee,FL,S.W. Florida,85,2827000,33258.82352941176,110,3267000,29700.0,-25,-440000
2018,county,48029,Bexar,12071,Lee,FL,S.W. Florida,66,1861000,28196.969696969696,75,2115000,28200.0,-9,-254000
2018,county,48453,Travis,12073,Leon,FL,Rural Florida,59,1674000,28372.881355932204,72,1609000,22347.222222222223,-13,65000
2018,county,48029,Bexar,13179,Liberty,GA,Rural Georgia,105,1534000,14609.52380952381,76,1598000,21026.315789473683,29,-64000
2018,county,48491,Williamson,48299,Llano,TX,Rural Texas,79,2556000,32354.430379746835,120,12811000,106758.33333333333,-41,-10255000
2018,county,48453,Travis,48299,Llano,TX,Rural Texas,95,10263000,108031.57894736843,149,8246000,55342.281879194634,-54,2017000
2018,county,48029,Bexar,48299,Llano,TX,Rural Texas,41,1825000,44512.19512195122,41,3546000,86487.80487804877,0,-1721000
2018,county,48491,Williamson,06037,Los Angeles,CA,Los Angeles,665,24687000,37123.308270676695,198,9949000,50247.47474747475,467,14738000
2018,county,48453,Travis,06037,Los Angeles,CA,Los Angeles,1634,104559000,63989.596083231336,1110,52086000,46924.32432432433,524,52473000
2018,county,48209,Hays,06037,Los Angeles,CA,Los Angeles,121,8282000,68446.28099173553,42,1808000,43047.619047619046,79,6474000
2018,county,48029,Bexar,06037,Los Angeles,CA,Los Angeles,1000,35400000,35400.0,589,20278000,34427.84380305603,411,15122000
2018,county,48453,Travis,51107,Loudoun,VA,Rural Virginia,82,3825000,46646.34146341463,54,2510000,46481.48148148148,28,1315000
2018,county,48029,Bexar,51107,Loudoun,VA,Rural Virginia,100,4177000,41770.0,76,2503000,32934.21052631579,24,1674000
2018,county,48029,Bexar,13185,Lowndes,GA,Rural Georgia,42,839000,19976.190476190477,52,1030000,19807.69230769231,-10,-191000
2018,county,48491,Williamson,48303,Lubbock,TX,Rural Texas,181,5879000,32480.662983425413,168,4049000,24101.190476190477,13,1830000
2018,county,48453,Travis,48303,Lubbock,TX,Rural Texas,290,11106000,38296.55172413793,179,5308000,29653.631284916202,111,5798000
2018,county,48209,Hays,48303,Lubbock,TX,Rural Texas,66,1626000,24636.363636363636,39,1130000,28974.358974358973,27,496000
2018,county,48091,Comal,48303,Lubbock,TX,Rural Texas,80,1873000,23412.5,41,1366000,33317.07317073171,39,507000
2018,county,48029,Bexar,48303,Lubbock,TX,Rural Texas,392,10143000,25875.0,257,5963000,23202.334630350193,135,4180000
2018,county,48453,Travis,26099,Macomb,MI,Rural Michigan,64,2014000,31468.75,55,985000,17909.090909090908,9,1029000
2018,county,48029,Bexar,01089,Madison,AL,Huntsville,58,1384000,23862.068965517243,82,2361000,28792.682926829268,-24,-977000
2018,county,48453,Travis,12081,Manatee,FL,Rural Florida,41,1178000,28731.70731707317,53,2781000,52471.698113207545,-12,-1603000
2018,county,48491,Williamson,04013,Maricopa,AZ,Phoenix,368,17856000,48521.739130434784,269,10041000,37327.1375464684,99,7815000
2018,county,48453,Travis,04013,Maricopa,AZ,Phoenix,656,36813000,56117.37804878049,753,29480000,39150.06640106242,-97,7333000
2018,county,48209,Hays,04013,Maricopa,AZ,Phoenix,72,2137000,29680.555555555555,101,4489000,44445.544554455446,-29,-2352000
2018,county,48091,Comal,04013,Maricopa,AZ,Phoenix,66,2790000,42272.72727272727,49,1911000,39000.0,17,879000
2018,county,48029,Bexar,04013,Maricopa,AZ,Phoenix,749,23451000,31309.746328437916,826,28142000,34070.217917675545,-77,-4691000
2018,county,48453,Travis,06041,Marin,CA,Bay Area,118,29084000,246474.57627118644,28,2562000,91500.0,90,26522000
2018,county,48453,Travis,18097,Marion,IN,Indianapolis,88,3043000,34579.545454545456,84,2406000,28642.85714285714,4,637000
2018,county,48029,Bexar,18097,Marion,IN,Indianapolis,129,3108000,24093.023255813954,75,1709000,22786.666666666668,54,1399000
2018,county,48453,Travis,48323,Maverick,TX,Rural Texas,66,707000,10712.121212121212,32,600000,18750.0,34,107000
2018,county,48029,Bexar,48323,Maverick,TX,Rural Texas,571,9181000,16078.809106830122,354,5080000,14350.282485875707,217,4101000
2018,county,48491,Williamson,48309,McLennan,TX,Rural Texas,237,6187000,26105.48523206751,208,5188000,24942.30769230769,29,999000
2018,county,48453,Travis,48309,McLennan,TX,Rural Texas,367,12157000,33125.34059945504,308,10297000,33431.818181818184,59,1860000
2018,county,48209,Hays,48309,McLennan,TX,Rural Texas,59,1822000,30881.35593220339,62,1910000,30806.451612903227,-3,-88000
2018,county,48091,Comal,48309,McLennan,TX,Rural Texas,44,1155000,26250.0,33,1112000,33696.969696969696,11,43000
2018,county,48029,Bexar,48309,McLennan,TX,Rural Texas,231,5773000,24991.341991341993,203,4981000,24536.94581280788,28,792000
2018,county,48491,Williamson,37119,Mecklenburg,NC,Charlotte,65,2791000,42938.46153846154,74,3430000,46351.35135135135,-9,-639000
2018,county,48453,Travis,37119,Mecklenburg,NC,Charlotte,194,11318000,58340.20618556701,164,17028000,103829.26829268293,30,-5710000
2018,county,48029,Bexar,37119,Mecklenburg,NC,Charlotte,121,5228000,43206.61157024794,171,8315000,48625.73099415204,-50,-3087000
2018,county,48029,Bexar,48325,Medina,TX,Rural Texas,1151,26931000,23397.914856646395,1658,41397000,24968.033775633292,-507,-14466000
2018,county,48491,Williamson,12086,Miami-Dade,FL,Miami,138,5315000,38514.49275362319,37,1437000,38837.83783783784,101,3878000
2018,county,48453,Travis,12086,Miami-Dade,FL,Miami,478,16083000,33646.44351464435,505,11762000,23291.08910891089,-27,4321000
2018,county,48029,Bexar,12086,Miami-Dade,FL,Miami,276,6480000,23478.260869565216,200,10914000,54570.0,76,-4434000
2018,county,48491,Williamson,25017,Middlesex,MA,Boston,74,3361000,45418.91891891892,42,1878000,44714.28571428572,32,1483000
2018,county,48453,Travis,25017,Middlesex,MA,Boston,297,31741000,106872.05387205388,230,10177000,44247.82608695652,67,21564000
2018,county,48453,Travis,34023,Middlesex,NJ,New York,123,4653000,37829.26829268293,71,3298000,46450.704225352114,52,1355000
2018,county,48029,Bexar,25017,Middlesex,MA,Boston,131,4738000,36167.93893129771,100,3984000,39840.0,31,754000
2018,county,48029,Bexar,34023,Middlesex,NJ,New York,68,2273000,33426.470588235294,56,1388000,24785.714285714286,12,885000
2018,county,48491,Williamson,48329,Midland,TX,Rural Texas,143,5313000,37153.846153846156,60,2266000,37766.666666666664,83,3047000
2018,county,48453,Travis,48329,Midland,TX,Rural Texas,176,8796000,49977.27272727273,183,6393000,34934.42622950819,-7,2403000
2018,county,48029,Bexar,48329,Midland,TX,Rural Texas,350,11408000,32594.285714285714,298,9655000,32399.328859060402,52,1753000
2018,county,48491,Williamson,48331,Milam,TX,Rural Texas,189,3705000,19603.174603174604,307,8067000,26276.872964169383,-118,-4362000
2018,county,48453,Travis,48331,Milam,TX,Rural Texas,69,1859000,26942.028985507248,104,2101000,20201.923076923078,-35,-242000
2018,county,48453,Travis,55079,Milwaukee,WI,Milwaukee,119,5045000,42394.95798319328,100,2346000,23460.0,19,2699000
2018,county,48029,Bexar,55079,Milwaukee,WI,Milwaukee,120,2799000,23325.0,81,1426000,17604.938271604937,39,1373000
2018,county,48453,Travis,01097,Mobile,AL,Mobile,34,854000,25117.647058823528,50,546000,10920.0,-16,308000
2018,county,48029,Bexar,01097,Mobile,AL,Mobile,78,1438000,18435.897435897437,45,990000,22000.0,33,448000
2018,county,48453,Travis,36055,Monroe,NY,Rochester,78,2998000,38435.89743589744,40,1630000,40750.0,38,1368000
2018,county,48029,Bexar,36055,Monroe,NY,Rochester,46,1187000,25804.347826086956,51,1569000,30764.70588235294,-5,-382000
2018,county,48029,Bexar,06053,Monterey,CA,Rural California,130,2830000,21769.23076923077,75,2325000,31000.0,55,505000
2018,county,48491,Williamson,48339,Montgomery,TX,Houston,283,12806000,45250.88339222615,204,7515000,36838.23529411765,79,5291000
2018,county,48453,Travis,48339,Montgomery,TX,Houston,497,40315000,81116.70020120725,386,21034000,54492.22797927461,111,19281000
2018,county,48453,Travis,24031,Montgomery,MD,D.C.,182,15440000,84835.16483516483,156,6311000,40455.1282051282,26,9129000
2018,county,48453,Travis,42091,Montgomery,PA,Philadelphia,83,3874000,46674.698795180724,57,2797000,49070.17543859649,26,1077000
2018,county,48453,Travis,39113,Montgomery,OH,Rural Ohio,43,1438000,33441.86046511628,59,1136000,19254.237288135595,-16,302000
2018,county,48209,Hays,48339,Montgomery,TX,Houston,113,3939000,34858.407079646015,79,2521000,31911.392405063292,34,1418000
2018,county,48091,Comal,48339,Montgomery,TX,Houston,159,7184000,45182.38993710692,75,2893000,38573.333333333336,84,4291000
2018,county,48029,Bexar,48339,Montgomery,TX,Houston,405,12792000,31585.185185185186,391,13178000,33703.324808184145,14,-386000
2018,county,48029,Bexar,24031,Montgomery,MD,D.C.,279,11271000,40397.84946236559,179,6226000,34782.122905027936,100,5045000
2018,county,48029,Bexar,47125,Montgomery,TN,Rural Tennessee,179,3338000,18648.04469273743,140,3029000,21635.714285714286,39,309000
2018,county,48029,Bexar,39113,Montgomery,OH,Rural Ohio,124,3078000,24822.58064516129,131,3026000,23099.236641221374,-7,52000
2018,county,48029,Bexar,01101,Montgomery,AL,Montgomery,107,3158000,29514.018691588786,86,3073000,35732.558139534885,21,85000
2018,county,48453,Travis,34027,Morris,NJ,New York,83,8606000,103686.7469879518,28,1489000,53178.57142857143,55,7117000
2018,county,48453,Travis,41051,Multnomah,OR,Portland,185,7990000,43189.18918918919,224,9950000,44419.642857142855,-39,-1960000
2018,county,48029,Bexar,41051,Multnomah,OR,Portland,78,3186000,40846.153846153844,80,3133000,39162.5,-2,53000
2018,county,48029,Bexar,13215,Muscogee,GA,Columbus,115,2547000,22147.82608695652,85,2103000,24741.176470588234,30,444000
2018,county,48453,Travis,48347,Nacogdoches,TX,Rural Texas,50,1161000,23220.0,30,1119000,37300.0,20,42000
2018,county,48453,Travis,36059,Nassau,NY,New York,101,4805000,47574.25742574257,41,3077000,75048.78048780488,60,1728000
2018,county,48453,Travis,10003,New Castle,DE,Rural Delaware,39,3199000,82025.64102564103,53,1255000,23679.245283018867,-14,1944000
2018,county,48453,Travis,09009,New Haven,CT,New Haven,109,5887000,54009.1743119266,65,1920000,29538.46153846154,44,3967000
2018,county,48029,Bexar,09009,New Haven,CT,New Haven,76,2140000,28157.894736842107,57,1302000,22842.105263157893,19,838000
2018,county,48491,Williamson,36061,New York,NY,New York,38,2680000,70526.31578947368,35,2160000,61714.28571428572,3,520000
2018,county,48453,Travis,36061,New York,NY,New York,591,114408000,193583.75634517765,448,40406000,90191.96428571429,143,74002000
2018,county,48029,Bexar,36061,New York,NY,New York,115,6661000,57921.739130434784,88,7922000,90022.72727272728,27,-1261000
2018,county,48029,Bexar,51700,Newport News city,VA,Hampton Roads,98,2497000,25479.591836734693,50,1311000,26220.0,48,1186000
2018,county,48453,Travis,25021,Norfolk,MA,Boston,96,6779000,70614.58333333333,59,3611000,61203.38983050847,37,3168000
2018,county,48029,Bexar,51710,Norfolk city,VA,Hampton Roads,83,1825000,21987.951807228917,62,1073000,17306.451612903227,21,752000
2018,county,48491,Williamson,48355,Nueces,TX,Rural Texas,284,9025000,31778.169014084506,181,6585000,36381.21546961326,103,2440000
2018,county,48453,Travis,48355,Nueces,TX,Rural Texas,446,14359000,32195.06726457399,284,8518000,29992.957746478874,162,5841000
2018,county,48209,Hays,48355,Nueces,TX,Rural Texas,119,3877000,32579.831932773108,111,4298000,38720.72072072072,8,-421000
2018,county,48091,Comal,48355,Nueces,TX,Rural Texas,163,5700000,34969.32515337423,83,2817000,33939.75903614458,80,2883000
2018,county,48029,Bexar,48355,Nueces,TX,Rural Texas,1676,41962000,25036.992840095467,967,22769000,23546.018614270943,709,19193000
2018,county,48453,Travis,26125,Oakland,MI,Detroit,118,5580000,47288.13559322034,104,7741000,74432.69230769231,14,-2161000
2018,county,48029,Bexar,26125,Oakland,MI,Detroit,115,3616000,31443.478260869564,97,5010000,51649.48453608248,18,-1394000
2018,county,48453,Travis,12091,Okaloosa,FL,FL Panhandle,33,883000,26757.575757575756,43,1204000,28000.0,-10,-321000
2018,county,48029,Bexar,12091,Okaloosa,FL,FL Panhandle,314,8695000,27691.08280254777,273,7263000,26604.395604395606,41,1432000
2018,county,48491,Williamson,40109,Oklahoma,OK,Oklahoma City,72,4496000,62444.444444444445,61,2553000,41852.45901639344,11,1943000
2018,county,48453,Travis,40109,Oklahoma,OK,Oklahoma City,178,8294000,46595.50561797753,164,5435000,33140.243902439026,14,2859000
2018,county,48029,Bexar,40109,Oklahoma,OK,Oklahoma City,312,8058000,25826.923076923078,224,6825000,30468.75,88,1233000
2018,county,48029,Bexar,36067,Onondaga,NY,Rural New York,45,1388000,30844.444444444445,39,1487000,38128.205128205125,6,-99000
2018,county,48029,Bexar,37133,Onslow,NC,Rural North Carolina,142,2699000,19007.042253521126,125,2410000,19280.0,17,289000
2018,county,48491,Williamson,06059,Orange,CA,Los Angeles,410,16587000,40456.09756097561,135,5138000,38059.25925925926,275,11449000
2018,county,48491,Williamson,12095,Orange,FL,Orlando,88,2529000,28738.636363636364,61,2004000,32852.45901639344,27,525000
2018,county,48453,Travis,06059,Orange,CA,Los Angeles,675,43174000,63961.48148148148,347,16950000,48847.26224783862,328,26224000
2018,county,48453,Travis,12095,Orange,FL,Orlando,187,6628000,35443.850267379676,267,8932000,33453.183520599254,-80,-2304000
2018,county,48029,Bexar,06059,Orange,CA,Los Angeles,414,15477000,37384.057971014496,249,8375000,33634.53815261044,165,7102000
2018,county,48029,Bexar,12095,Orange,FL,Orlando,221,4922000,22271.493212669684,172,7945000,46191.86046511628,49,-3023000
2018,county,48453,Travis,22071,Orleans Parish,LA,New Orleans,168,7425000,44196.42857142857,169,5752000,34035.502958579884,-1,1673000
2018,county,48029,Bexar,22071,Orleans Parish,LA,New Orleans,90,2547000,28300.0,115,3090000,26869.565217391304,-25,-543000
2018,county,48453,Travis,12097,Osceola,FL,Orlando,43,1041000,24209.302325581397,67,1094000,16328.358208955224,-24,-53000
2018,county,48029,Bexar,12097,Osceola,FL,Orlando,47,900000,19148.936170212764,47,1282000,27276.59574468085,0,-382000
2018,county,48029,Bexar,35035,Otero,NM,Rural New Mexico,112,1856000,16571.428571428572,106,2294000,21641.509433962263,6,-438000
2018,county,48491,Williamson,12099,Palm Beach,FL,Miami,94,3013000,32053.191489361703,47,1958000,41659.574468085106,47,1055000
2018,county,48453,Travis,12099,Palm Beach,FL,Miami,252,14917000,59194.444444444445,269,7565000,28122.67657992565,-17,7352000
2018,county,48029,Bexar,12099,Palm Beach,FL,Miami,121,3544000,29289.256198347106,99,3020000,30505.050505050505,22,524000
2018,county,48491,Williamson,48367,Parker,TX,Dallas-Fort Worth,40,1607000,40175.0,58,2325000,40086.206896551725,-18,-718000
2018,county,48453,Travis,48367,Parker,TX,Dallas-Fort Worth,59,2014000,34135.59322033898,77,3177000,41259.74025974026,-18,-1163000
2018,county,48029,Bexar,48367,Parker,TX,Dallas-Fort Worth,41,1431000,34902.439024390245,99,3224000,32565.656565656565,-58,-1793000
2018,county,48453,Travis,12101,Pasco,FL,Tampa,45,1183000,26288.88888888889,68,1566000,23029.41176470588,-23,-383000
2018,county,48029,Bexar,12101,Pasco,FL,Tampa,64,1869000,29203.125,70,1683000,24042.85714285714,-6,186000
2018,county,48453,Travis,42101,Philadelphia,PA,Philadelphia,142,6195000,43626.76056338028,173,5478000,31664.739884393064,-31,717000
2018,county,48029,Bexar,42101,Philadelphia,PA,Philadelphia,70,2250000,32142.85714285714,49,1407000,28714.285714285714,21,843000
2018,county,48491,Williamson,53053,Pierce,WA,Seattle,115,3861000,33573.913043478264,54,1186000,21962.962962962964,61,2675000
2018,county,48453,Travis,53053,Pierce,WA,Seattle,92,3061000,33271.739130434784,118,3768000,31932.20338983051,-26,-707000
2018,county,48029,Bexar,53053,Pierce,WA,Seattle,444,10355000,23322.07207207207,379,9751000,25728.232189973616,65,604000
2018,county,48491,Williamson,04019,Pima,AZ,Tucson,78,3221000,41294.8717948718,41,1662000,40536.58536585366,37,1559000
2018,county,48453,Travis,04019,Pima,AZ,Tucson,137,5026000,36686.131386861314,132,5801000,43946.969696969696,5,-775000
2018,county,48029,Bexar,04019,Pima,AZ,Tucson,248,7152000,28838.709677419356,223,5891000,26417.040358744394,25,1261000
2018,county,48029,Bexar,04021,Pinal,AZ,Phoenix,69,1178000,17072.463768115944,62,1195000,19274.1935483871,7,-17000
2018,county,48491,Williamson,12103,Pinellas,FL,Tampa,36,1339000,37194.444444444445,50,1784000,35680.0,-14,-445000
2018,county,48453,Travis,12103,Pinellas,FL,Tampa,105,4203000,40028.57142857143,155,5520000,35612.903225806454,-50,-1317000
2018,county,48029,Bexar,12103,Pinellas,FL,Tampa,106,3158000,29792.45283018868,84,2988000,35571.42857142857,22,170000
2018,county,48029,Bexar,06061,Placer,CA,Sacramento,55,1923000,34963.63636363636,93,2652000,28516.129032258064,-38,-729000
2018,county,48453,Travis,12105,Polk,FL,Orlando,75,1225000,16333.333333333334,75,1691000,22546.666666666668,0,-466000
2018,county,48453,Travis,48373,Polk,TX,Rural Texas,43,2251000,52348.83720930233,73,3197000,43794.520547945205,-30,-946000
2018,county,48029,Bexar,12105,Polk,FL,Orlando,64,1268000,19812.5,67,2161000,32253.731343283584,-3,-893000
2018,county,48029,Bexar,19153,Polk,IA,Rural Iowa,69,1948000,28231.884057971016,55,2080000,37818.181818181816,14,-132000
2018,county,48029,Bexar,48375,Potter,TX,Rural Texas,68,1908000,28058.823529411766,59,880000,14915.254237288136,9,1028000
2018,county,48453,Travis,24033,Prince George,MD,Rural Maryland,62,1924000,31032.25806451613,82,2128000,25951.219512195123,-20,-204000
2018,county,48029,Bexar,24033,Prince George,MD,Rural Maryland,171,5926000,34654.97076023392,163,4868000,29865.030674846625,8,1058000
2018,county,48029,Bexar,51153,Prince William,VA,Rural Virginia,189,6800000,35978.83597883598,125,3904000,31232.0,64,2896000
2018,county,48453,Travis,44007,Providence,RI,Providence,52,2488000,47846.153846153844,45,1793000,39844.444444444445,7,695000
2018,county,48453,Travis,05119,Pulaski,AR,Little Rock,82,1764000,21512.19512195122,72,1966000,27305.555555555555,10,-202000
2018,county,48029,Bexar,05119,Pulaski,AR,Little Rock,142,4916000,34619.718309859156,60,1765000,29416.666666666668,82,3151000
2018,county,48029,Bexar,29169,Pulaski,MO,Rural Missouri,104,3003000,28875.0,89,2249000,25269.662921348314,15,754000
2018,county,48453,Travis,36081,Queens,NY,New York,225,11693000,51968.88888888889,116,3446000,29706.896551724138,109,8247000
2018,county,48029,Bexar,36081,Queens,NY,New York,136,4045000,29742.647058823528,52,1578000,30346.153846153848,84,2467000
2018,county,48453,Travis,27123,Ramsey,MN,Minneapolis,70,3646000,52085.71428571428,51,2402000,47098.03921568627,19,1244000
2018,county,48453,Travis,48381,Randall,TX,Rural Texas,58,1734000,29896.55172413793,38,1379000,36289.47368421053,20,355000
2018,county,48029,Bexar,48381,Randall,TX,Rural Texas,108,2819000,26101.85185185185,92,1851000,20119.565217391304,16,968000
2018,county,48453,Travis,45079,Richland,SC,Columbia,74,5718000,77270.27027027027,45,1332000,29600.0,29,4386000
2018,county,48029,Bexar,45079,Richland,SC,Columbia,119,2443000,20529.41176470588,91,2654000,29164.835164835164,28,-211000
2018,county,48029,Bexar,13245,Richmond,GA,Rural Georgia,117,3674000,31401.709401709402,113,2225000,19690.265486725664,4,1449000
2018,county,48491,Williamson,06065,Riverside,CA,San Bernardino-Riverside,225,6498000,28880.0,48,1006000,20958.333333333332,177,5492000
2018,county,48453,Travis,06065,Riverside,CA,San Bernardino-Riverside,248,8770000,35362.903225806454,331,5262000,15897.280966767372,-83,3508000
2018,county,48029,Bexar,06065,Riverside,CA,San Bernardino-Riverside,367,7142000,19460.490463215257,183,4635000,25327.868852459018,184,2507000
2018,county,48453,Travis,48397,Rockwall,TX,Dallas-Fort Worth,59,2013000,34118.64406779661,67,2573000,38402.985074626864,-8,-560000
2018,county,48029,Bexar,48397,Rockwall,TX,Dallas-Fort Worth,38,1097000,28868.42105263158,62,1939000,31274.1935483871,-24,-842000
2018,county,48491,Williamson,06067,Sacramento,CA,Sacramento,103,3806000,36951.45631067961,49,1991000,40632.65306122449,54,1815000
2018,county,48453,Travis,06067,Sacramento,CA,Sacramento,135,8177000,60570.37037037037,150,3792000,25280.0,-15,4385000
2018,county,48029,Bexar,06067,Sacramento,CA,Sacramento,191,5031000,26340.314136125653,126,3238000,25698.4126984127,65,1793000
2018,county,48453,Travis,49035,Salt Lake,UT,Salt Lake,190,7922000,41694.73684210526,194,6720000,34639.17525773196,-4,1202000
2018,county,48029,Bexar,49035,Salt Lake,UT,Salt Lake,189,5701000,30164.021164021164,171,7460000,43625.73099415204,18,-1759000
2018,county,48491,Williamson,06071,San Bernardino,CA,San Bernardino-Riverside,170,4554000,26788.235294117647,53,1929000,36396.22641509434,117,2625000
2018,county,48453,Travis,06071,San Bernardino,CA,San Bernardino-Riverside,155,3715000,23967.74193548387,161,2525000,15683.229813664597,-6,1190000
2018,county,48029,Bexar,06071,San Bernardino,CA,San Bernardino-Riverside,383,7405000,19334.20365535248,161,3163000,19645.962732919255,222,4242000
2018,county,48491,Williamson,06073,San Diego,CA,San Diego,521,18980000,36429.9424184261,168,8990000,53511.90476190476,353,9990000
2018,county,48453,Travis,06073,San Diego,CA,San Diego,806,40298000,49997.51861042184,461,25013000,54258.13449023861,345,15285000
2018,county,48209,Hays,06073,San Diego,CA,San Diego,85,4155000,48882.35294117647,42,2418000,57571.42857142857,43,1737000
2018,county,48029,Bexar,06073,San Diego,CA,San Diego,1027,24916000,24260.95423563778,671,16189000,24126.676602086438,356,8727000
2018,county,48453,Travis,06075,San Francisco,CA,Bay Area,486,84905000,174701.64609053498,270,24669000,91366.66666666667,216,60236000
2018,county,48029,Bexar,06075,San Francisco,CA,Bay Area,47,2234000,47531.914893617024,54,4378000,81074.07407407407,-7,-2144000
2018,county,48029,Bexar,06077,San Joaquin,CA,Bay Area,76,1312000,17263.157894736843,41,1186000,28926.829268292684,35,126000
2018,county,48453,Travis,06081,San Mateo,CA,Bay Area,305,32976000,108118.03278688525,136,13981000,102801.4705882353,169,18995000
2018,county,48029,Bexar,06081,San Mateo,CA,Bay Area,64,1005000,15703.125,32,3614000,112937.5,32,-2609000
2018,county,48453,Travis,48409,San Patricio,TX,Rural Texas,78,1987000,25474.358974358973,49,1545000,31530.61224489796,29,442000
2018,county,48029,Bexar,48409,San Patricio,TX,Rural Texas,293,6164000,21037.54266211604,140,3776000,26971.428571428572,153,2388000
2018,county,48453,Travis,06083,Santa Barbara,CA,Rural California,93,4522000,48623.655913978495,43,1691000,39325.58139534884,50,2831000
2018,county,48029,Bexar,06083,Santa Barbara,CA,Rural California,154,4041000,26240.25974025974,67,1550000,23134.328358208953,87,2491000
2018,county,48491,Williamson,06085,Santa Clara,CA,Bay Area,585,40891000,69899.1452991453,182,9840000,54065.93406593407,403,31051000
2018,county,48453,Travis,06085,Santa Clara,CA,Bay Area,1064,127518000,119847.74436090226,524,37508000,71580.15267175573,540,90010000
2018,county,48029,Bexar,06085,Santa Clara,CA,Bay Area,186,7257000,39016.12903225807,178,7593000,42657.30337078652,8,-336000
2018,county,48453,Travis,35049,Santa Fe,NM,Rural New Mexico,53,4513000,85150.94339622642,95,4690000,49368.42105263158,-42,-177000
2018,county,48029,Bexar,12113,Santa Rosa,FL,FL Panhandle,86,1882000,21883.720930232557,92,2573000,27967.391304347828,-6,-691000
2018,county,48453,Travis,12115,Sarasota,FL,S.W. Florida,66,3328000,50424.242424242424,55,4227000,76854.54545454546,11,-899000
2018,county,48453,Travis,36091,Saratoga,NY,Rural New York,73,4368000,59835.61643835616,38,1712000,45052.63157894737,35,2656000
2018,county,48029,Bexar,31153,Sarpy,NE,Omaha,152,3729000,24532.894736842107,126,3008000,23873.015873015873,26,721000
2018,county,48453,Travis,20173,Sedgwick,KS,Rural Kansas,50,2603000,52060.0,47,2168000,46127.65957446808,3,435000
2018,county,48029,Bexar,20173,Sedgwick,KS,Rural Kansas,148,4074000,27527.027027027027,119,2303000,19352.941176470587,29,1771000
2018,county,48453,Travis,12117,Seminole,FL,Orlando,45,1762000,39155.555555555555,64,1736000,27125.0,-19,26000
2018,county,48029,Bexar,12117,Seminole,FL,Orlando,55,1483000,26963.636363636364,63,1822000,28920.634920634922,-8,-339000
2018,county,48491,Williamson,47157,Shelby,TN,Memphis,64,1925000,30078.125,48,1437000,29937.5,16,488000
2018,county,48453,Travis,47157,Shelby,TN,Memphis,155,8207000,52948.3870967742,162,4504000,27802.46913580247,-7,3703000
2018,county,48029,Bexar,47157,Shelby,TN,Memphis,164,5414000,33012.19512195122,129,3545000,27480.62015503876,35,1869000
2018,county,48491,Williamson,48423,Smith,TX,Rural Texas,129,3119000,24178.294573643412,85,2814000,33105.882352941175,44,305000
2018,county,48453,Travis,48423,Smith,TX,Rural Texas,169,5068000,29988.165680473372,129,5388000,41767.441860465115,40,-320000
2018,county,48029,Bexar,48423,Smith,TX,Rural Texas,126,3004000,23841.26984126984,151,3433000,22735.099337748343,-25,-429000
2018,county,48453,Travis,53061,Snohomish,WA,Seattle,105,4516000,43009.52380952381,104,4545000,43701.92307692308,1,-29000
2018,county,48029,Bexar,53061,Snohomish,WA,Seattle,103,3454000,33533.98058252427,81,1847000,22802.46913580247,22,1607000
2018,county,48029,Bexar,06095,Solano,CA,Bay Area,175,4656000,26605.714285714286,195,5135000,26333.333333333332,-20,-479000
2018,county,48453,Travis,53063,Spokane,WA,Spokane,39,1436000,36820.51282051282,73,1319000,18068.49315068493,-34,117000
2018,county,48029,Bexar,53063,Spokane,WA,Spokane,87,1821000,20931.03448275862,100,2204000,22040.0,-13,-383000
2018,county,48029,Bexar,17163,St. Clair,IL,St. Louis,173,4676000,27028.901734104045,135,2870000,21259.25925925926,38,1806000
2018,county,48453,Travis,12109,St. Johns,FL,Jacksonville,32,1803000,56343.75,44,3609000,82022.72727272728,-12,-1806000
2018,county,48453,Travis,29189,St. Louis,MO,St. Louis,109,7258000,66587.15596330275,147,6694000,45537.4149659864,-38,564000
2018,county,48029,Bexar,29189,St. Louis,MO,St. Louis,90,2687000,29855.555555555555,115,7224000,62817.391304347824,-25,-4537000
2018,county,48453,Travis,29510,St. Louis city,MO,Rural Missouri,39,1925000,49358.97435897436,57,1834000,32175.43859649123,-18,91000
2018,county,48029,Bexar,29510,St. Louis city,MO,Rural Missouri,49,1639000,33448.97959183674,34,1763000,51852.94117647059,15,-124000
2018,county,48453,Travis,25025,Suffolk,MA,Boston,175,15924000,90994.28571428571,123,10176000,82731.70731707317,52,5748000
2018,county,48453,Travis,36103,Suffolk,NY,New York,98,6791000,69295.91836734694,52,1455000,27980.76923076923,46,5336000
2018,county,48029,Bexar,25025,Suffolk,MA,Boston,52,2333000,44865.38461538462,61,2502000,41016.39344262295,-9,-169000
2018,county,48029,Bexar,45085,Sumter,SC,Rural South Carolina,47,1396000,29702.127659574468,86,1721000,20011.627906976744,-39,-325000
2018,county,48491,Williamson,48439,Tarrant,TX,Dallas-Fort Worth,581,20660000,35559.380378657486,512,17883000,34927.734375,69,2777000
2018,county,48453,Travis,48439,Tarrant,TX,Dallas-Fort Worth,1168,47406000,40587.32876712329,1020,37171000,36442.1568627451,148,10235000
2018,county,48209,Hays,48439,Tarrant,TX,Dallas-Fort Worth,185,6656000,35978.37837837838,175,4571000,26120.0,10,2085000
2018,county,48091,Comal,48439,Tarrant,TX,Dallas-Fort Worth,129,5095000,39496.124031007756,84,2980000,35476.19047619047,45,2115000
2018,county,48029,Bexar,48439,Tarrant,TX,Dallas-Fort Worth,1158,33798000,29186.528497409327,1235,38195000,30927.125506072876,-77,-4397000
2018,county,48491,Williamson,48441,Taylor,TX,Rural Texas,90,2911000,32344.444444444445,60,1626000,27100.0,30,1285000
2018,county,48453,Travis,48441,Taylor,TX,Rural Texas,107,2711000,25336.448598130843,79,2414000,30556.962025316454,28,297000
2018,county,48029,Bexar,48441,Taylor,TX,Rural Texas,248,5918000,23862.90322580645,197,4519000,22939.086294416244,51,1399000
2018,county,48453,Travis,53067,Thurston,WA,Rural Washington,36,1407000,39083.333333333336,58,1137000,19603.44827586207,-22,270000
2018,county,48029,Bexar,53067,Thurston,WA,Rural Washington,97,3054000,31484.536082474227,105,2642000,25161.904761904763,-8,412000
2018,county,48491,Williamson,48451,Tom Green,TX,Rural Texas,125,3823000,30584.0,45,1285000,28555.555555555555,80,2538000
2018,county,48453,Travis,48451,Tom Green,TX,Rural Texas,111,3014000,27153.153153153155,69,1422000,20608.695652173912,42,1592000
2018,county,48029,Bexar,48451,Tom Green,TX,Rural Texas,405,7956000,19644.444444444445,249,6257000,25128.5140562249,156,1699000
2018,county,48491,Williamson,48453,Travis,TX,Austin,20278,713801000,35200.759443732124,13620,486484000,35718.35535976505,6658,227317000
2018,county,48209,Hays,48453,Travis,TX,Austin,7592,322788000,42516.85985247629,3853,127096000,32986.24448481703,3739,195692000
2018,county,48091,Comal,48453,Travis,TX,Austin,480,27174000,56612.5,328,11656000,35536.58536585366,152,15518000
2018,county,48029,Bexar,48453,Travis,TX,Austin,2265,71701000,31656.0706401766,2694,99955000,37102.82108389013,-429,-28254000
2018,county,48491,Williamson,40143,Tulsa,OK,Tulsa,39,1460000,37435.89743589744,58,2043000,35224.137931034486,-19,-583000
2018,county,48453,Travis,40143,Tulsa,OK,Tulsa,119,6133000,51537.815126050424,89,2210000,24831.460674157304,30,3923000
2018,county,48029,Bexar,40143,Tulsa,OK,Tulsa,139,3519000,25316.54676258993,111,3557000,32045.045045045044,28,-38000
2018,county,48491,Williamson,49049,Utah,UT,Rural Utah,102,1861000,18245.098039215685,59,1296000,21966.101694915254,43,565000
2018,county,48453,Travis,49049,Utah,UT,Rural Utah,98,801000,8173.469387755102,39,851000,21820.51282051282,59,-50000
2018,county,48029,Bexar,49049,Utah,UT,Rural Utah,133,3082000,23172.93233082707,102,2729000,26754.901960784315,31,353000
2018,county,48029,Bexar,48463,Uvalde,TX,Rural Texas,239,4469000,18698.744769874476,160,3615000,22593.75,79,854000
2018,county,48453,Travis,48465,Val Verde,TX,Rural Texas,50,1324000,26480.0,35,704000,20114.285714285714,15,620000
2018,county,48029,Bexar,48465,Val Verde,TX,Rural Texas,372,7862000,21134.40860215054,319,6052000,18971.7868338558,53,1810000
2018,county,48453,Travis,06111,Ventura,CA,Los Angeles,134,4192000,31283.582089552237,72,2269000,31513.88888888889,62,1923000
2018,county,48029,Bexar,06111,Ventura,CA,Los Angeles,89,3171000,35629.213483146064,50,981000,19620.0,39,2190000
2018,county,48029,Bexar,22115,Vernon Parish,LA,Rural Louisiana,134,2276000,16985.074626865673,69,1292000,18724.63768115942,65,984000
2018,county,48491,Williamson,48469,Victoria,TX,Rural Texas,67,2002000,29880.597014925374,35,1075000,30714.285714285714,32,927000
2018,county,48453,Travis,48469,Victoria,TX,Rural Texas,168,4874000,29011.904761904763,75,2748000,36640.0,93,2126000
2018,county,48029,Bexar,48469,Victoria,TX,Rural Texas,260,6591000,25350.0,143,2966000,20741.25874125874,117,3625000
2018,county,48453,Travis,51810,Virginia Beach city,VA,Hampton Roads,63,2553000,40523.80952380953,37,892000,24108.108108108107,26,1661000
2018,county,48029,Bexar,51810,Virginia Beach city,VA,Hampton Roads,205,3810000,18585.365853658535,133,3659000,27511.27819548872,72,151000
2018,county,48453,Travis,12127,Volusia,FL,Atlantic Coast,60,2421000,40350.0,82,1408000,17170.731707317074,-22,1013000
2018,county,48491,Williamson,37183,Wake,NC,Raleigh,71,2708000,38140.84507042253,88,3915000,44488.63636363636,-17,-1207000
2018,county,48453,Travis,37183,Wake,NC,Raleigh,248,18867000,76076.6129032258,185,14196000,76735.13513513513,63,4671000
2018,county,48029,Bexar,37183,Wake,NC,Raleigh,139,4033000,29014.38848920863,89,3792000,42606.74157303371,50,241000
2018,county,48491,Williamson,41067,Washington,OR,Portland,91,4143000,45527.47252747253,49,1508000,30775.51020408163,42,2635000
2018,county,48453,Travis,41067,Washington,OR,Portland,195,11588000,59425.64102564102,132,8180000,61969.69696969697,63,3408000
2018,county,48453,Travis,48477,Washington,TX,Rural Texas,41,1737000,42365.85365853659,30,941000,31366.666666666668,11,796000
2018,county,48453,Travis,05143,Washington,AR,Rural Arkansas,48,1522000,31708.333333333332,46,3235000,70326.08695652174,2,-1713000
2018,county,48029,Bexar,41067,Washington,OR,Portland,75,2404000,32053.333333333332,115,4847000,42147.82608695652,-40,-2443000
2018,county,48491,Williamson,32031,Washoe,NV,Rural Nevada,73,2297000,31465.753424657534,47,1512000,32170.212765957447,26,785000
2018,county,48453,Travis,32031,Washoe,NV,Rural Nevada,70,4862000,69457.14285714286,78,2784000,35692.307692307695,-8,2078000
2018,county,48029,Bexar,32031,Washoe,NV,Rural Nevada,81,2381000,29395.061728395063,42,1781000,42404.76190476191,39,600000
2018,county,48453,Travis,26161,Washtenaw,MI,Rural Michigan,89,3681000,41359.550561797754,74,2589000,34986.48648648649,15,1092000
2018,county,48453,Travis,26163,Wayne,MI,Detroit,141,4280000,30354.609929078015,267,3304000,12374.531835205993,-126,976000
2018,county,48029,Bexar,26163,Wayne,MI,Detroit,105,3730000,35523.80952380953,126,3097000,24579.365079365078,-21,633000
2018,county,48453,Travis,48479,Webb,TX,Rural Texas,223,5850000,26233.18385650224,128,2783000,21742.1875,95,3067000
2018,county,48209,Hays,48479,Webb,TX,Rural Texas,63,1243000,19730.15873015873,35,598000,17085.714285714286,28,645000
2018,county,48029,Bexar,48479,Webb,TX,Rural Texas,1423,23697000,16652.846099789178,658,12143000,18454.40729483283,765,11554000
2018,county,48029,Bexar,08123,Weld,CO,Rural Colorado,39,1258000,32256.410256410258,70,2347000,33528.57142857143,-31,-1089000
2018,county,48453,Travis,36119,Westchester,NY,New York,101,14777000,146306.9306930693,66,4753000,72015.15151515152,35,10024000
2018,county,48029,Bexar,36119,Westchester,NY,New York,46,3233000,70282.60869565218,41,1741000,42463.41463414634,5,1492000
2018,county,48453,Travis,48485,Wichita,TX,Rural Texas,102,5218000,51156.86274509804,43,1637000,38069.767441860466,59,3581000
2018,county,48029,Bexar,48485,Wichita,TX,Rural Texas,138,3113000,22557.971014492752,106,2104000,19849.056603773584,32,1009000
2018,county,48029,Bexar,17197,Will,IL,Chicago,82,2508000,30585.365853658535,35,878000,25085.714285714286,47,1630000
2018,county,48453,Travis,48491,Williamson,TX,Austin,13620,486484000,35718.35535976505,20278,713801000,35200.759443732124,-6658,-227317000
2018,county,48453,Travis,47187,Williamson,TN,Nashville,43,2303000,53558.13953488372,63,3260000,51746.031746031746,-20,-957000
2018,county,48209,Hays,48491,Williamson,TX,Austin,698,22540000,32292.263610315185,838,25152000,30014.319809069213,-140,-2612000
2018,county,48091,Comal,48491,Williamson,TX,Austin,224,8005000,35736.607142857145,136,4871000,35816.17647058824,88,3134000
2018,county,48029,Bexar,48491,Williamson,TX,Austin,754,23154000,30708.222811671087,948,28860000,30443.037974683546,-194,-5706000
2018,county,48091,Comal,48493,Wilson,TX,Rural Texas,68,2484000,36529.41176470588,117,3109000,26572.649572649574,-49,-625000
2018,county,48029,Bexar,48493,Wilson,TX,Rural Texas,1036,27225000,26278.95752895753,1482,59414000,40090.41835357625,-446,-32189000
2018,county,48453,Travis,25027,Worcester,MA,Rural Massachusetts,80,4051000,50637.5,42,2326000,55380.95238095238,38,1725000
2018,county,48029,Bexar,51199,York,VA,Hampton Roads,138,2832000,20521.739130434784,91,2572000,28263.736263736264,47,260000
2018,county,48029,Bexar,48507,Zavala,TX,Rural Texas,61,999000,16377.04918032787,67,999000,14910.44776119403,-6,0
2018,total,48491,Williamson,96000,,,,51144,1818808000,35562.49022368215,35100,1244948000,35468.60398860399,16044,573860000
2018,total,48453,Travis,96000,,,,78514,3884317000,49472.92202664493,84469,3238771000,38342.71744663723,-5955,645546000
2018,total,48209,Hays,96000,,,,18695,710893000,38025.83578496924,14048,415538000,29579.86902050114,4647,295355000
2018,total,48091,Comal,96000,,,,16383,643962000,39306.72038088262,9687,343378000,35447.30050583256,6696,300584000
2018,total,48029,Bexar,96000,,,,81365,2308578000,28373.108830578258,76985,2387824000,31016.74352146522,4380,-79246000
2019,county,48491,Williamson,16001,Ada,ID,Rural Idaho,64,2343000,36609.375,51,1862000,36509.80392156863,13,481000
2019,county,48453,Travis,16001,Ada,ID,Rural Idaho,71,4056000,57126.76056338028,84,4149000,49392.857142857145,-13,-93000
2019,county,48029,Bexar,16001,Ada,ID,Rural Idaho,50,1558000,31160.0,56,1680000,30000.0,-6,-122000
2019,county,48453,Travis,08001,Adams,CO,Denver,78,2216000,28410.25641025641,74,2643000,35716.21621621621,4,-427000
2019,county,48029,Bexar,08001,Adams,CO,Denver,103,3152000,30601.941747572815,112,2792000,24928.571428571428,-9,360000
2019,county,48491,Williamson,06001,Alameda,CA,Bay Area,418,25434000,60846.88995215311,58,3029000,52224.137931034486,360,22405000
2019,county,48453,Travis,06001,Alameda,CA,Bay Area,556,40884000,73532.37410071942,303,19837000,65468.64686468647,253,21047000
2019,county,48029,Bexar,06001,Alameda,CA,Bay Area,173,7092000,40994.21965317919,101,2810000,27821.78217821782,72,4282000
2019,county,48453,Travis,51510,Alexandria city,VA,D.C.,98,6908000,70489.79591836735,37,1641000,44351.35135135135,61,5267000
2019,county,48029,Bexar,51510,Alexandria city,VA,D.C.,66,4370000,66212.12121212122,97,4170000,42989.69072164949,-31,200000
2019,county,48453,Travis,42003,Allegheny,PA,Pittsburgh,138,9251000,67036.23188405797,91,4710000,51758.241758241755,47,4541000
2019,county,48029,Bexar,42003,Allegheny,PA,Pittsburgh,105,4353000,41457.142857142855,49,2120000,43265.30612244898,56,2233000
2019,county,48029,Bexar,02020,Anchorage Borough,AK,Rural Alaska,196,5718000,29173.469387755104,189,5240000,27724.867724867723,7,478000
2019,county,48453,Travis,24003,Anne Arundel,MD,Baltimore,95,4239000,44621.05263157895,30,2114000,70466.66666666667,65,2125000
2019,county,48029,Bexar,24003,Anne Arundel,MD,Baltimore,282,10277000,36443.26241134752,227,6096000,26854.625550660792,55,4181000
2019,county,48453,Travis,48007,Aransas,TX,Rural Texas,41,2135000,52073.170731707316,50,1661000,33220.0,-9,474000
2019,county,48029,Bexar,48007,Aransas,TX,Rural Texas,68,2401000,35308.82352941176,98,3753000,38295.91836734694,-30,-1352000
2019,county,48491,Williamson,08005,Arapahoe,CO,Denver,111,3438000,30972.972972972973,61,1869000,30639.344262295082,50,1569000
2019,county,48453,Travis,08005,Arapahoe,CO,Denver,153,10508000,68679.7385620915,128,6273000,49007.8125,25,4235000
2019,county,48029,Bexar,08005,Arapahoe,CO,Denver,269,10851000,40338.28996282528,182,5305000,29148.351648351647,87,5546000
2019,county,48453,Travis,51013,Arlington,VA,D.C.,150,12282000,81880.0,70,3475000,49642.857142857145,80,8807000
2019,county,48029,Bexar,51013,Arlington,VA,D.C.,63,5135000,81507.93650793651,101,7603000,75277.22772277228,-38,-2468000
2019,county,48029,Bexar,48013,Atascosa,TX,Rural Texas,1334,25052000,18779.610194902547,1806,33612000,18611.295681063122,-472,-8560000
2019,county,48029,Bexar,24005,Baltimore,MD,Baltimore,70,2887000,41242.857142857145,35,1244000,35542.857142857145,35,1643000
2019,county,48453,Travis,24510,Baltimore city,MD,Baltimore,88,3923000,44579.545454545456,32,1345000,42031.25,56,2578000
2019,county,48029,Bexar,48019,Bandera,TX,Rural Texas,274,7631000,27850.36496350365,566,16432000,29031.802120141343,-292,-8801000
2019,county,48491,Williamson,48021,Bastrop,TX,Austin,411,10743000,26138.68613138686,435,13854000,31848.275862068964,-24,-3111000
2019,county,48453,Travis,48021,Bastrop,TX,Austin,1711,38893000,22731.15137346581,3038,63615000,20939.763001974985,-1327,-24722000
2019,county,48209,Hays,48021,Bastrop,TX,Austin,264,5903000,22359.848484848484,295,8689000,29454.237288135595,-31,-2786000
2019,county,48029,Bexar,48021,Bastrop,TX,Austin,93,1354000,14559.139784946237,104,3063000,29451.923076923078,-11,-1709000
2019,county,48029,Bexar,12005,Bay,FL,FL Panhandle,180,4580000,25444.444444444445,54,1716000,31777.777777777777,126,2864000
2019,county,48029,Bexar,48025,Bee,TX,Rural Texas,136,3222000,23691.176470588234,92,1693000,18402.17391304348,44,1529000
2019,county,48491,Williamson,48027,Bell,TX,Rural Texas,1722,45300000,26306.620209059234,1696,44509000,26243.514150943396,26,791000
2019,county,48453,Travis,48027,Bell,TX,Rural Texas,1255,27419000,21847.80876494024,1419,27214000,19178.294573643412,-164,205000
2019,county,48209,Hays,48027,Bell,TX,Rural Texas,160,3346000,20912.5,167,3641000,21802.395209580838,-7,-295000
2019,county,48091,Comal,48027,Bell,TX,Rural Texas,82,2804000,34195.12195121951,75,2070000,27600.0,7,734000
2019,county,48029,Bexar,48027,Bell,TX,Rural Texas,977,21823000,22336.745138178096,829,18850000,22738.238841978287,148,2973000
2019,county,48453,Travis,05007,Benton,AR,Rural Arkansas,84,4247000,50559.52380952381,77,5174000,67194.8051948052,7,-927000
2019,county,48029,Bexar,05007,Benton,AR,Rural Arkansas,71,3107000,43760.56338028169,57,2348000,41192.98245614035,14,759000
2019,county,48453,Travis,34003,Bergen,NJ,New York,88,4459000,50670.454545454544,48,2723000,56729.166666666664,40,1736000
2019,county,48491,Williamson,35001,Bernalillo,NM,Albuquerque,72,4427000,61486.11111111111,49,1984000,40489.795918367345,23,2443000
2019,county,48453,Travis,35001,Bernalillo,NM,Albuquerque,141,8085000,57340.425531914894,130,7900000,60769.230769230766,11,185000
2019,county,48029,Bexar,35001,Bernalillo,NM,Albuquerque,252,8555000,33948.4126984127,172,5675000,32994.186046511626,80,2880000
2019,county,48491,Williamson,48029,Bexar,TX,San Antonio,1022,34792000,34043.052837573385,700,21620000,30885.714285714286,322,13172000
2019,county,48453,Travis,48029,Bexar,TX,San Antonio,2691,114493000,42546.636937941286,2230,88050000,39484.304932735424,461,26443000
2019,county,48209,Hays,48029,Bexar,TX,San Antonio,653,24147000,36978.560490045944,778,21280000,27352.185089974293,-125,2867000
2019,county,48091,Comal,48029,Bexar,TX,San Antonio,4391,173464000,39504.44090184468,2122,78589000,37035.34401508011,2269,94875000
2019,county,48453,Travis,48031,Blanco,TX,Rural Texas,48,940000,19583.333333333332,88,3839000,43625.0,-40,-2899000
2019,county,48209,Hays,48031,Blanco,TX,Rural Texas,73,3644000,49917.808219178085,99,3890000,39292.92929292929,-26,-246000
2019,county,48091,Comal,48031,Blanco,TX,Rural Texas,113,4778000,42283.18584070796,80,2666000,33325.0,33,2112000
2019,county,48029,Bexar,48031,Blanco,TX,Rural Texas,60,1445000,24083.333333333332,96,4360000,45416.666666666664,-36,-2915000
2019,county,48029,Bexar,22015,Bossier Parish,LA,Rural Louisiana,100,2388000,23880.0,96,2619000,27281.25,4,-231000
2019,county,48453,Travis,08013,Boulder,CO,Denver,101,6205000,61435.64356435643,162,15718000,97024.69135802469,-61,-9513000
2019,county,48029,Bexar,08013,Boulder,CO,Denver,48,2410000,50208.333333333336,48,2612000,54416.666666666664,0,-202000
2019,county,48491,Williamson,48039,Brazoria,TX,Houston,125,5436000,43488.0,62,2431000,39209.67741935484,63,3005000
2019,county,48453,Travis,48039,Brazoria,TX,Houston,186,6679000,35908.602150537634,143,4688000,32783.21678321678,43,1991000
2019,county,48209,Hays,48039,Brazoria,TX,Houston,85,3832000,45082.35294117647,53,1236000,23320.754716981133,32,2596000
2019,county,48029,Bexar,48039,Brazoria,TX,Houston,195,7134000,36584.61538461538,200,6349000,31745.0,-5,785000
2019,county,48491,Williamson,48041,Brazos,TX,Rural Texas,254,7266000,28606.299212598424,155,5216000,33651.6129032258,99,2050000
2019,county,48453,Travis,48041,Brazos,TX,Rural Texas,510,18380000,36039.21568627451,254,9094000,35803.149606299216,256,9286000
2019,county,48209,Hays,48041,Brazos,TX,Rural Texas,123,3962000,32211.38211382114,59,3604000,61084.745762711864,64,358000
2019,county,48091,Comal,48041,Brazos,TX,Rural Texas,54,2878000,53296.2962962963,29,1013000,34931.03448275862,25,1865000
2019,county,48029,Bexar,48041,Brazos,TX,Rural Texas,300,8822000,29406.666666666668,300,9496000,31653.333333333332,0,-674000
2019,county,48453,Travis,12009,Brevard,FL,Atlantic Coast,50,2913000,58260.0,51,2241000,43941.17647058824,-1,672000
2019,county,48029,Bexar,12009,Brevard,FL,Atlantic Coast,141,4048000,28709.21985815603,162,5873000,36253.08641975309,-21,-1825000
2019,county,48453,Travis,36005,Bronx,NY,New York,41,1007000,24560.975609756097,42,848000,20190.47619047619,-1,159000
2019,county,48029,Bexar,36005,Bronx,NY,New York,77,1709000,22194.805194805194,31,582000,18774.1935483871,46,1127000
2019,county,48491,Williamson,12011,Broward,FL,Miami,103,2868000,27844.660194174758,52,1847000,35519.230769230766,51,1021000
2019,county,48453,Travis,12011,Broward,FL,Miami,260,8913000,34280.769230769234,165,8216000,49793.93939393939,95,697000
2019,county,48029,Bexar,12011,Broward,FL,Miami,252,8124000,32238.095238095237,150,5992000,39946.666666666664,102,2132000
2019,county,48453,Travis,37021,Buncombe,NC,Asheville,41,1673000,40804.87804878049,71,3918000,55183.09859154929,-30,-2245000
2019,county,48029,Bexar,34005,Burlington,NJ,Philadelphia,136,2680000,19705.882352941175,85,2093000,24623.529411764706,51,587000
2019,county,48491,Williamson,48053,Burnet,TX,Rural Texas,431,15221000,35315.54524361949,653,26250000,40199.08116385911,-222,-11029000
2019,county,48453,Travis,48053,Burnet,TX,Rural Texas,436,19375000,44438.07339449541,536,27585000,51464.55223880597,-100,-8210000
2019,county,48209,Hays,48053,Burnet,TX,Rural Texas,44,1452000,33000.0,97,4371000,45061.85567010309,-53,-2919000
2019,county,48029,Bexar,48053,Burnet,TX,Rural Texas,86,2389000,27779.06976744186,95,17949000,188936.84210526315,-9,-15560000
2019,county,48029,Bexar,22017,Caddo Parish,LA,Rural Louisiana,48,1280000,26666.666666666668,35,1305000,37285.71428571428,13,-25000
2019,county,48491,Williamson,48055,Caldwell,TX,Rural Texas,84,1811000,21559.52380952381,126,3700000,29365.079365079364,-42,-1889000
2019,county,48453,Travis,48055,Caldwell,TX,Rural Texas,500,8893000,17786.0,1040,22193000,21339.423076923078,-540,-13300000
2019,county,48209,Hays,48055,Caldwell,TX,Rural Texas,712,14265000,20035.112359550563,723,14661000,20278.008298755187,-11,-396000
2019,county,48091,Comal,48055,Caldwell,TX,Rural Texas,89,1598000,17955.05617977528,81,1556000,19209.876543209877,8,42000
2019,county,48029,Bexar,48055,Caldwell,TX,Rural Texas,99,1723000,17404.040404040403,104,1855000,17836.53846153846,-5,-132000
2019,county,48491,Williamson,48061,Cameron,TX,Rural Texas,154,3997000,25954.545454545456,87,2624000,30160.919540229886,67,1373000
2019,county,48453,Travis,48061,Cameron,TX,Rural Texas,372,9960000,26774.1935483871,233,6261000,26871.244635193132,139,3699000
2019,county,48209,Hays,48061,Cameron,TX,Rural Texas,102,2728000,26745.098039215685,78,1171000,15012.820512820514,24,1557000
2019,county,48029,Bexar,48061,Cameron,TX,Rural Texas,1053,22950000,21794.871794871793,628,13738000,21875.79617834395,425,9212000
2019,county,48029,Bexar,30013,Cascade,MT,Rural Montana,54,1375000,25462.962962962964,62,1490000,24032.25806451613,-8,-115000
2019,county,48453,Travis,45019,Charleston,SC,Charleston,52,2691000,51750.0,38,1586000,41736.84210526316,14,1105000
2019,county,48029,Bexar,45019,Charleston,SC,Charleston,84,2901000,34535.71428571428,73,1711000,23438.35616438356,11,1190000
2019,county,48029,Bexar,13051,Chatham,GA,Savannah,66,2301000,34863.63636363636,40,1041000,26025.0,26,1260000
2019,county,48453,Travis,42029,Chester,PA,Philadelphia,53,4241000,80018.8679245283,47,2408000,51234.04255319149,6,1833000
2019,county,48029,Bexar,21047,Christian,KY,Rural Kentucky,84,1305000,15535.714285714286,45,962000,21377.777777777777,39,343000
2019,county,48453,Travis,41005,Clackamas,OR,Portland,44,5198000,118136.36363636363,46,2541000,55239.13043478261,-2,2657000
2019,county,48491,Williamson,32003,Clark,NV,Las Vegas,231,7684000,33264.069264069265,137,4527000,33043.79562043796,94,3157000
2019,county,48453,Travis,32003,Clark,NV,Las Vegas,348,18150000,52155.1724137931,264,13780000,52196.969696969696,84,4370000
2019,county,48453,Travis,53011,Clark,WA,Portland,57,3095000,54298.245614035084,67,6144000,91701.49253731343,-10,-3049000
2019,county,48091,Comal,32003,Clark,NV,Las Vegas,52,2137000,41096.153846153844,44,2058000,46772.72727272727,8,79000
2019,county,48029,Bexar,32003,Clark,NV,Las Vegas,620,21825000,35201.6129032258,658,18357000,27898.176291793312,-38,3468000
2019,county,48029,Bexar,53011,Clark,WA,Portland,48,1430000,29791.666666666668,53,1252000,23622.64150943396,-5,178000
2019,county,48453,Travis,40027,Cleveland,OK,Oklahoma City,74,2502000,33810.81081081081,43,1361000,31651.162790697676,31,1141000
2019,county,48029,Bexar,40027,Cleveland,OK,Oklahoma City,69,1829000,26507.246376811596,74,2114000,28567.567567567567,-5,-285000
2019,county,48453,Travis,13067,Cobb,GA,Atlanta,124,4846000,39080.645161290326,94,3926000,41765.95744680851,30,920000
2019,county,48029,Bexar,13067,Cobb,GA,Atlanta,88,2653000,30147.727272727272,118,3529000,29906.77966101695,-30,-876000
2019,county,48029,Bexar,04003,Cochise,AZ,Rural Arizona,89,2690000,30224.719101123595,56,1108000,19785.714285714286,33,1582000
2019,county,48453,Travis,12021,Collier,FL,S.W. Florida,63,3014000,47841.269841269845,45,2135000,47444.444444444445,18,879000
2019,county,48491,Williamson,48085,Collin,TX,Dallas-Fort Worth,447,18881000,42239.37360178971,502,20145000,40129.482071713144,-55,-1264000
2019,county,48453,Travis,48085,Collin,TX,Dallas-Fort Worth,819,47658000,58190.47619047619,764,35429000,46373.03664921466,55,12229000
2019,county,48209,Hays,48085,Collin,TX,Dallas-Fort Worth,134,8687000,64828.35820895522,73,2341000,32068.49315068493,61,6346000
2019,county,48091,Comal,48085,Collin,TX,Dallas-Fort Worth,90,4653000,51700.0,48,2140000,44583.333333333336,42,2513000
2019,county,48029,Bexar,48085,Collin,TX,Dallas-Fort Worth,480,19854000,41362.5,744,30314000,40744.62365591398,-264,-10460000
2019,county,48029,Bexar,13073,Columbia,GA,Augusta,120,3223000,26858.333333333332,155,3789000,24445.16129032258,-35,-566000
2019,county,48491,Williamson,48091,Comal,TX,San Antonio,142,6274000,44183.09859154929,217,7817000,36023.041474654376,-75,-1543000
2019,county,48453,Travis,48091,Comal,TX,San Antonio,361,19637000,54396.12188365651,464,22746000,49021.55172413793,-103,-3109000
2019,county,48209,Hays,48091,Comal,TX,San Antonio,607,20870000,34382.20757825371,964,31756000,32941.908713692945,-357,-10886000
2019,county,48029,Bexar,48091,Comal,TX,San Antonio,2122,78589000,37035.34401508011,4391,173464000,39504.44090184468,-2269,-94875000
2019,county,48029,Bexar,40031,Comanche,OK,Rural Oklahoma,149,3055000,20503.355704697988,68,1565000,23014.70588235294,81,1490000
2019,county,48453,Travis,06013,Contra Costa,CA,Bay Area,319,29281000,91789.96865203761,73,5657000,77493.1506849315,246,23624000
2019,county,48029,Bexar,06013,Contra Costa,CA,Bay Area,92,4221000,45880.434782608696,69,5085000,73695.65217391304,23,-864000
2019,county,48491,Williamson,17031,Cook,IL,Chicago,241,9167000,38037.34439834025,95,3173000,33400.0,146,5994000
2019,county,48453,Travis,17031,Cook,IL,Chicago,1009,102772000,101855.30227948463,542,32817000,60547.970479704796,467,69955000
2019,county,48029,Bexar,17031,Cook,IL,Chicago,585,23038000,39381.19658119658,327,9847000,30113.149847094803,258,13191000
2019,county,48491,Williamson,48099,Coryell,TX,Rural Texas,177,4646000,26248.58757062147,149,3550000,23825.5033557047,28,1096000
2019,county,48453,Travis,48099,Coryell,TX,Rural Texas,114,2467000,21640.35087719298,117,2681000,22914.529914529914,-3,-214000
2019,county,48029,Bexar,48099,Coryell,TX,Rural Texas,203,3199000,15758.620689655172,134,2310000,17238.805970149253,69,889000
2019,county,48453,Travis,23005,Cumberland,ME,Portland,58,2211000,38120.68965517241,36,1135000,31527.777777777777,22,1076000
2019,county,48029,Bexar,37051,Cumberland,NC,Rural North Carolina,383,7709000,20127.937336814623,254,6214000,24464.56692913386,129,1495000
2019,county,48029,Bexar,35009,Curry,NM,Rural New Mexico,108,2540000,23518.51851851852,84,1770000,21071.428571428572,24,770000
2019,county,48453,Travis,39035,Cuyahoga,OH,Cleveland,120,7014000,58450.0,59,2220000,37627.1186440678,61,4794000
2019,county,48029,Bexar,39035,Cuyahoga,OH,Cleveland,74,3845000,51959.45945945946,71,3359000,47309.859154929574,3,486000
2019,county,48491,Williamson,48113,Dallas,TX,Dallas-Fort Worth,593,25192000,42482.2934232715,541,24048000,44451.016635859516,52,1144000
2019,county,48453,Travis,48113,Dallas,TX,Dallas-Fort Worth,2082,141981000,68194.52449567724,1722,96944000,56297.32868757259,360,45037000
2019,county,48209,Hays,48113,Dallas,TX,Dallas-Fort Worth,198,9654000,48757.57575757576,191,5363000,28078.534031413612,7,4291000
2019,county,48091,Comal,48113,Dallas,TX,Dallas-Fort Worth,108,7217000,66824.07407407407,95,3450000,36315.78947368421,13,3767000
2019,county,48029,Bexar,48113,Dallas,TX,Dallas-Fort Worth,1237,54550000,44098.62570735651,1400,49762000,35544.28571428572,-163,4788000
2019,county,48453,Travis,55025,Dane,WI,Madison,152,8610000,56644.73684210526,54,2196000,40666.666666666664,98,6414000
2019,county,48029,Bexar,55025,Dane,WI,Madison,88,2993000,34011.36363636364,38,1415000,37236.84210526316,50,1578000
2019,county,48491,Williamson,47037,Davidson,TN,Nashville,47,1496000,31829.787234042553,43,2551000,59325.58139534884,4,-1055000
2019,county,48453,Travis,47037,Davidson,TN,Nashville,160,10086000,63037.5,189,11291000,59740.74074074074,-29,-1205000
2019,county,48029,Bexar,47037,Davidson,TN,Nashville,90,3478000,38644.444444444445,81,3435000,42407.40740740741,9,43000
2019,county,48029,Bexar,49011,Davis,UT,Rural Utah,111,2639000,23774.774774774774,149,3046000,20442.953020134228,-38,-407000
2019,county,48453,Travis,13089,DeKalb,GA,Atlanta,119,7029000,59067.226890756305,93,4963000,53365.591397849465,26,2066000
2019,county,48029,Bexar,13089,DeKalb,GA,Atlanta,70,2158000,30828.571428571428,81,4631000,57172.83950617284,-11,-2473000
2019,county,48491,Williamson,48121,Denton,TX,Dallas-Fort Worth,342,15122000,44216.37426900585,369,16677000,45195.12195121951,-27,-1555000
2019,county,48453,Travis,48121,Denton,TX,Dallas-Fort Worth,673,34100000,50668.647845468055,565,24244000,42909.734513274336,108,9856000
2019,county,48209,Hays,48121,Denton,TX,Dallas-Fort Worth,108,4101000,37972.22222222222,111,3855000,34729.72972972973,-3,246000
2019,county,48091,Comal,48121,Denton,TX,Dallas-Fort Worth,106,5173000,48801.88679245283,37,2425000,65540.54054054055,69,2748000
2019,county,48029,Bexar,48121,Denton,TX,Dallas-Fort Worth,414,14879000,35939.61352657005,621,25670000,41336.553945249594,-207,-10791000
2019,county,48491,Williamson,08031,Denver,CO,Denver,45,1557000,34600.0,62,2706000,43645.16129032258,-17,-1149000
2019,county,48453,Travis,08031,Denver,CO,Denver,326,23925000,73389.57055214724,425,27255000,64129.41176470588,-99,-3330000
2019,county,48029,Bexar,08031,Denver,CO,Denver,169,6020000,35621.30177514793,197,11375000,57741.11675126904,-28,-5355000
2019,county,48453,Travis,41017,Deschutes,OR,Rural Oregon,34,1575000,46323.529411764706,61,4431000,72639.34426229508,-27,-2856000
2019,county,48029,Bexar,48127,Dimmit,TX,Rural Texas,70,2479000,35414.28571428572,44,913000,20750.0,26,1566000
2019,county,48453,Travis,11001,District of Columbia,DC,D.C.,290,26862000,92627.58620689655,206,12067000,58577.669902912625,84,14795000
2019,county,48029,Bexar,11001,District of Columbia,DC,D.C.,105,6490000,61809.52380952381,99,5108000,51595.9595959596,6,1382000
2019,county,48453,Travis,35013,Dona Ana,NM,Rural New Mexico,82,3215000,39207.31707317073,39,986000,25282.05128205128,43,2229000
2019,county,48029,Bexar,35013,Dona Ana,NM,Rural New Mexico,111,3401000,30639.63963963964,83,1639000,19746.98795180723,28,1762000
2019,county,48491,Williamson,08035,Douglas,CO,Denver,94,5202000,55340.425531914894,64,2862000,44718.75,30,2340000
2019,county,48453,Travis,31055,Douglas,NE,Omaha,80,3391000,42387.5,36,1450000,40277.77777777778,44,1941000
2019,county,48453,Travis,08035,Douglas,CO,Denver,98,5966000,60877.551020408166,81,3369000,41592.59259259259,17,2597000
2019,county,48029,Bexar,31055,Douglas,NE,Omaha,117,4893000,41820.51282051282,73,2536000,34739.72602739726,44,2357000
2019,county,48029,Bexar,08035,Douglas,CO,Denver,65,2731000,42015.38461538462,100,3316000,33160.0,-35,-585000
2019,county,48453,Travis,17043,DuPage,IL,Chicago,158,11268000,71316.45569620254,74,3532000,47729.72972972973,84,7736000
2019,county,48029,Bexar,17043,DuPage,IL,Chicago,127,4638000,36519.68503937008,72,1985000,27569.444444444445,55,2653000
2019,county,48453,Travis,37063,Durham,NC,Raleigh,97,5479000,56484.536082474224,85,3471000,40835.294117647056,12,2008000
2019,county,48491,Williamson,12031,Duval,FL,Jacksonville,47,1590000,33829.78723404255,40,1613000,40325.0,7,-23000
2019,county,48453,Travis,12031,Duval,FL,Jacksonville,135,6323000,46837.03703703704,84,2461000,29297.619047619046,51,3862000
2019,county,48029,Bexar,12031,Duval,FL,Jacksonville,130,3538000,27215.384615384617,159,4315000,27138.364779874213,-29,-777000
2019,county,48453,Travis,22033,East Baton Rouge Parish,LA,Rural Louisiana,162,6239000,38512.345679012345,73,3290000,45068.49315068493,89,2949000
2019,county,48029,Bexar,22033,East Baton Rouge Parish,LA,Rural Louisiana,88,2100000,23863.636363636364,54,1555000,28796.296296296296,34,545000
2019,county,48453,Travis,48135,Ector,TX,Rural Texas,113,5075000,44911.50442477876,96,2458000,25604.166666666668,17,2617000
2019,county,48029,Bexar,48135,Ector,TX,Rural Texas,310,9155000,29532.25806451613,243,4490000,18477.366255144032,67,4665000
2019,county,48491,Williamson,48141,El Paso,TX,El Paso,266,9212000,34631.57894736842,125,2852000,22816.0,141,6360000
2019,county,48491,Williamson,08041,El Paso,CO,Colorado Springs,134,3200000,23880.597014925374,117,2860000,24444.444444444445,17,340000
2019,county,48453,Travis,48141,El Paso,TX,El Paso,574,18096000,31526.132404181186,334,10423000,31206.586826347306,240,7673000
2019,county,48453,Travis,08041,El Paso,CO,Colorado Springs,187,7164000,38310.16042780749,225,11143000,49524.444444444445,-38,-3979000
2019,county,48209,Hays,48141,El Paso,TX,El Paso,91,1870000,20549.45054945055,73,1659000,22726.027397260274,18,211000
2019,county,48091,Comal,08041,El Paso,CO,Colorado Springs,52,1661000,31942.30769230769,43,1481000,34441.86046511628,9,180000
2019,county,48029,Bexar,48141,El Paso,TX,El Paso,1364,34058000,24969.208211143694,1042,23497000,22549.90403071017,322,10561000
2019,county,48029,Bexar,08041,El Paso,CO,Colorado Springs,676,17508000,25899.40828402367,716,19957000,27872.90502793296,-40,-2449000
2019,county,48491,Williamson,48139,Ellis,TX,Dallas-Fort Worth,55,1923000,34963.63636363636,54,1788000,33111.11111111111,1,135000
2019,county,48453,Travis,48139,Ellis,TX,Dallas-Fort Worth,69,2195000,31811.594202898552,52,2401000,46173.07692307692,17,-206000
2019,county,48029,Bexar,48139,Ellis,TX,Dallas-Fort Worth,83,2237000,26951.807228915663,120,3502000,29183.333333333332,-37,-1265000
2019,county,48453,Travis,36029,Erie,NY,Buffalo,57,2684000,47087.71929824561,35,1698000,48514.28571428572,22,986000
2019,county,48029,Bexar,12033,Escambia,FL,FL Panhandle,152,3185000,20953.947368421053,96,2395000,24947.916666666668,56,790000
2019,county,48453,Travis,25009,Essex,MA,Boston,88,4585000,52102.27272727273,39,1724000,44205.1282051282,49,2861000
2019,county,48029,Bexar,02090,Fairbanks North Star Borough,AK,Rural Alaska,116,2609000,22491.379310344826,116,2676000,23068.96551724138,0,-67000
2019,county,48491,Williamson,51059,Fairfax,VA,D.C.,129,6153000,47697.67441860465,79,2866000,36278.48101265823,50,3287000
2019,county,48453,Travis,51059,Fairfax,VA,D.C.,302,25276000,83695.36423841059,136,6621000,48683.82352941176,166,18655000
2019,county,48029,Bexar,51059,Fairfax,VA,D.C.,437,21251000,48629.29061784897,432,20926000,48439.81481481482,5,325000
2019,county,48453,Travis,09001,Fairfield,CT,New York,177,20344000,114937.85310734464,58,3507000,60465.51724137931,119,16837000
2019,county,48453,Travis,48149,Fayette,TX,Rural Texas,60,1694000,28233.333333333332,69,2787000,40391.30434782609,-9,-1093000
2019,county,48491,Williamson,48157,Fort Bend,TX,Houston,304,13389000,44042.76315789474,213,8579000,40276.99530516432,91,4810000
2019,county,48453,Travis,48157,Fort Bend,TX,Houston,659,41340000,62731.411229135054,466,18507000,39714.592274678114,193,22833000
2019,county,48209,Hays,48157,Fort Bend,TX,Houston,131,7451000,56877.86259541985,60,2814000,46900.0,71,4637000
2019,county,48091,Comal,48157,Fort Bend,TX,Houston,150,14262000,95080.0,37,2148000,58054.05405405405,113,12114000
2019,county,48029,Bexar,48157,Fort Bend,TX,Houston,494,18847000,38151.82186234818,506,20256000,40031.62055335968,-12,-1409000
2019,county,48453,Travis,39049,Franklin,OH,Columbus,192,15582000,81156.25,115,3473000,30200.0,77,12109000
2019,county,48029,Bexar,39049,Franklin,OH,Columbus,150,4187000,27913.333333333332,129,5727000,44395.348837209305,21,-1540000
2019,county,48453,Travis,06019,Fresno,CA,Fresno,74,2663000,35986.48648648649,48,1200000,25000.0,26,1463000
2019,county,48029,Bexar,06019,Fresno,CA,Fresno,80,2192000,27400.0,70,1006000,14371.42857142857,10,1186000
2019,county,48029,Bexar,48163,Frio,TX,Rural Texas,206,5254000,25504.85436893204,171,3674000,21485.380116959066,35,1580000
2019,county,48491,Williamson,13121,Fulton,GA,Atlanta,49,2510000,51224.489795918365,36,1592000,44222.22222222222,13,918000
2019,county,48453,Travis,13121,Fulton,GA,Atlanta,292,22915000,78476.02739726027,161,18493000,114863.35403726708,131,4422000
2019,county,48029,Bexar,13121,Fulton,GA,Atlanta,96,5307000,55281.25,114,6055000,53114.0350877193,-18,-748000
2019,county,48491,Williamson,48167,Galveston,TX,Houston,151,6185000,40960.26490066225,75,2580000,34400.0,76,3605000
2019,county,48453,Travis,48167,Galveston,TX,Houston,256,12756000,49828.125,209,8228000,39368.42105263158,47,4528000
2019,county,48209,Hays,48167,Galveston,TX,Houston,54,3217000,59574.07407407407,40,1263000,31575.0,14,1954000
2019,county,48029,Bexar,48167,Galveston,TX,Houston,223,8328000,37345.291479820626,254,7952000,31307.08661417323,-31,376000
2019,county,48029,Bexar,40047,Garfield,OK,Rural Oklahoma,61,1439000,23590.16393442623,44,1039000,23613.636363636364,17,400000
2019,county,48029,Bexar,20061,Geary,KS,Rural Kansas,124,2348000,18935.483870967742,92,1407000,15293.478260869566,32,941000
2019,county,48491,Williamson,48171,Gillespie,TX,Rural Texas,37,1531000,41378.37837837838,50,1927000,38540.0,-13,-396000
2019,county,48453,Travis,48171,Gillespie,TX,Rural Texas,63,2847000,45190.47619047619,70,5015000,71642.85714285714,-7,-2168000
2019,county,48029,Bexar,48171,Gillespie,TX,Rural Texas,95,2731000,28747.36842105263,139,6899000,49633.09352517986,-44,-4168000
2019,county,48029,Bexar,48177,Gonzales,TX,Rural Texas,85,1844000,21694.117647058825,45,1203000,26733.333333333332,40,641000
2019,county,48453,Travis,48181,Grayson,TX,Rural Texas,63,2789000,44269.84126984127,38,1288000,33894.73684210526,25,1501000
2019,county,48029,Bexar,48181,Grayson,TX,Rural Texas,43,1377000,32023.25581395349,51,1085000,21274.50980392157,-8,292000
2019,county,48029,Bexar,39057,Greene,OH,Rural Ohio,91,3098000,34043.956043956045,120,4632000,38600.0,-29,-1534000
2019,county,48453,Travis,45045,Greenville,SC,Greenville,43,1489000,34627.90697674418,54,3264000,60444.444444444445,-11,-1775000
2019,county,48029,Bexar,45045,Greenville,SC,Greenville,48,2754000,57375.0,50,1532000,30640.0,-2,1222000
2019,county,48453,Travis,48183,Gregg,TX,Rural Texas,64,1961000,30640.625,46,1601000,34804.34782608696,18,360000
2019,county,48029,Bexar,48183,Gregg,TX,Rural Texas,57,1288000,22596.491228070176,48,1327000,27645.833333333332,9,-39000
2019,county,48491,Williamson,48187,Guadalupe,TX,San Antonio,112,3848000,34357.142857142855,114,4184000,36701.754385964916,-2,-336000
2019,county,48453,Travis,48187,Guadalupe,TX,San Antonio,230,6820000,29652.17391304348,321,10015000,31199.3769470405,-91,-3195000
2019,county,48209,Hays,48187,Guadalupe,TX,San Antonio,638,15539000,24355.79937304075,785,16255000,20707.006369426752,-147,-716000
2019,county,48091,Comal,48187,Guadalupe,TX,San Antonio,2598,83472000,32129.33025404157,2079,61327000,29498.316498316497,519,22145000
2019,county,48029,Bexar,48187,Guadalupe,TX,San Antonio,3539,96568000,27286.804181972308,4357,118302000,27152.168923571266,-818,-21734000
2019,county,48453,Travis,37081,Guilford,NC,Greensboro,64,2127000,33234.375,33,1583000,47969.69696969697,31,544000
2019,county,48029,Bexar,37081,Guilford,NC,Greensboro,48,2065000,43020.833333333336,63,1289000,20460.31746031746,-15,776000
2019,county,48453,Travis,13135,Gwinnett,GA,Atlanta,87,2820000,32413.793103448275,81,1859000,22950.617283950618,6,961000
2019,county,48029,Bexar,13135,Gwinnett,GA,Atlanta,107,3195000,29859.81308411215,81,1559000,19246.913580246914,26,1636000
2019,county,48453,Travis,39061,Hamilton,OH,Cincinnati,98,4404000,44938.77551020408,44,2196000,49909.09090909091,54,2208000
2019,county,48453,Travis,47065,Hamilton,TN,Chattanooga,37,2434000,65783.78378378379,45,1972000,43822.22222222222,-8,462000
2019,county,48029,Bexar,39061,Hamilton,OH,Cincinnati,80,3393000,42412.5,58,2610000,45000.0,22,783000
2019,county,48029,Bexar,51650,Hampton city,VA,Hampton Roads,114,3539000,31043.859649122805,51,1717000,33666.666666666664,63,1822000
2019,county,48029,Bexar,37085,Harnett,NC,Rural North Carolina,150,3018000,20120.0,82,1851000,22573.170731707316,68,1167000
2019,county,48491,Williamson,48201,Harris,TX,Houston,1382,61098000,44209.84081041968,912,31997000,35084.429824561405,470,29101000
2019,county,48453,Travis,48201,Harris,TX,Houston,4058,298281000,73504.43568260227,2765,133521000,48289.692585895114,1293,164760000
2019,county,48209,Hays,48201,Harris,TX,Houston,639,37247000,58289.514866979654,488,14380000,29467.213114754097,151,22867000
2019,county,48091,Comal,48201,Harris,TX,Houston,578,36964000,63951.5570934256,284,13550000,47711.2676056338,294,23414000
2019,county,48029,Bexar,48201,Harris,TX,Houston,3163,101402000,32058.804932026556,2988,101942000,34117.135207496656,175,-540000
2019,county,48029,Bexar,28047,Harrison,MS,Gulfport-Biloxi,176,3269000,18573.863636363636,109,2925000,26834.8623853211,67,344000
2019,county,48453,Travis,09003,Hartford,CT,Hartford,68,3815000,56102.94117647059,56,2044000,36500.0,12,1771000
2019,county,48491,Williamson,48209,Hays,TX,Austin,822,24551000,29867.396593673966,669,24522000,36654.708520179374,153,29000
2019,county,48453,Travis,48209,Hays,TX,Austin,3956,233752000,59087.967644084936,7751,300117000,38719.778093149274,-3795,-66365000
2019,county,48091,Comal,48209,Hays,TX,Austin,964,31756000,32941.908713692945,607,20870000,34382.20757825371,357,10886000
2019,county,48029,Bexar,48209,Hays,TX,Austin,778,21280000,27352.185089974293,653,24147000,36978.560490045944,125,-2867000
2019,county,48029,Bexar,48213,Henderson,TX,Rural Texas,40,1184000,29600.0,32,1037000,32406.25,8,147000
2019,county,48491,Williamson,27053,Hennepin,MN,Minneapolis,98,3849000,39275.510204081635,41,1737000,42365.85365853659,57,2112000
2019,county,48453,Travis,27053,Hennepin,MN,Minneapolis,309,40578000,131320.38834951457,186,9443000,50768.81720430108,123,31135000
2019,county,48029,Bexar,27053,Hennepin,MN,Minneapolis,115,5705000,49608.69565217391,97,3995000,41185.56701030928,18,1710000
2019,county,48453,Travis,51087,Henrico,VA,Richmond,84,4671000,55607.142857142855,36,1478000,41055.555555555555,48,3193000
2019,county,48491,Williamson,48215,Hidalgo,TX,Rural Texas,218,4839000,22197.24770642202,112,2744000,24500.0,106,2095000
2019,county,48453,Travis,48215,Hidalgo,TX,Rural Texas,540,15644000,28970.37037037037,309,7154000,23152.10355987055,231,8490000
2019,county,48209,Hays,48215,Hidalgo,TX,Rural Texas,127,2794000,22000.0,54,1164000,21555.555555555555,73,1630000
2019,county,48091,Comal,48215,Hidalgo,TX,Rural Texas,89,2925000,32865.168539325845,57,3861000,67736.84210526316,32,-936000
2019,county,48029,Bexar,48215,Hidalgo,TX,Rural Texas,1430,37276000,26067.132867132867,818,17815000,21778.72860635697,612,19461000
2019,county,48491,Williamson,12057,Hillsborough,FL,Tampa,80,3691000,46137.5,77,2076000,26961.03896103896,3,1615000
2019,county,48453,Travis,12057,Hillsborough,FL,Tampa,179,9702000,54201.117318435754,167,8084000,48407.18562874252,12,1618000
2019,county,48029,Bexar,12057,Hillsborough,FL,Tampa,276,8380000,30362.318840579712,322,9598000,29807.45341614907,-46,-1218000
2019,county,48491,Williamson,15003,Honolulu,HI,Rural Hawaii,86,3452000,40139.53488372093,49,1140000,23265.30612244898,37,2312000
2019,county,48453,Travis,15003,Honolulu,HI,Rural Hawaii,171,8613000,50368.42105263158,74,2823000,38148.64864864865,97,5790000
2019,county,48029,Bexar,15003,Honolulu,HI,Rural Hawaii,859,23089000,26878.928987194413,584,15308000,26212.328767123287,275,7781000
2019,county,48029,Bexar,13153,Houston,GA,Rural Georgia,98,2430000,24795.918367346938,80,1901000,23762.5,18,529000
2019,county,48453,Travis,24027,Howard,MD,Baltimore,50,3068000,61360.0,37,1872000,50594.59459459459,13,1196000
2019,county,48029,Bexar,24027,Howard,MD,Baltimore,72,2852000,39611.11111111111,84,2801000,33345.23809523809,-12,51000
2019,county,48453,Travis,34017,Hudson,NJ,New York,173,11754000,67942.19653179191,66,3962000,60030.30303030303,107,7792000
2019,county,48453,Travis,29095,Jackson,MO,Kansas City,91,3441000,37813.18681318681,80,3692000,46150.0,11,-251000
2019,county,48029,Bexar,29095,Jackson,MO,Kansas City,120,2841000,23675.0,84,2413000,28726.190476190477,36,428000
2019,county,48029,Bexar,28059,Jackson,MS,Gulfport-Biloxi,53,1016000,19169.811320754718,72,1355000,18819.444444444445,-19,-339000
2019,county,48491,Williamson,48245,Jefferson,TX,Rural Texas,75,2685000,35800.0,51,1466000,28745.098039215685,24,1219000
2019,county,48491,Williamson,08059,Jefferson,CO,Denver,50,2458000,49160.0,60,2393000,39883.333333333336,-10,65000
2019,county,48453,Travis,48245,Jefferson,TX,Rural Texas,172,5253000,30540.697674418603,78,1695000,21730.76923076923,94,3558000
2019,county,48453,Travis,08059,Jefferson,CO,Denver,134,4918000,36701.49253731343,168,14892000,88642.85714285714,-34,-9974000
2019,county,48453,Travis,01073,Jefferson,AL,Birmingham,90,4791000,53233.333333333336,52,1485000,28557.69230769231,38,3306000
2019,county,48453,Travis,21111,Jefferson,KY,Louisville,79,4000000,50632.91139240506,59,3013000,51067.79661016949,20,987000
2019,county,48029,Bexar,48245,Jefferson,TX,Rural Texas,143,5565000,38916.08391608392,103,3138000,30466.019417475727,40,2427000
2019,county,48029,Bexar,08059,Jefferson,CO,Denver,92,2827000,30728.260869565216,68,3577000,52602.94117647059,24,-750000
2019,county,48029,Bexar,21111,Jefferson,KY,Louisville,78,4894000,62743.58974358974,67,3159000,47149.253731343284,11,1735000
2019,county,48029,Bexar,36045,Jefferson,NY,Rural New York,105,1959000,18657.14285714286,75,1544000,20586.666666666668,30,415000
2019,county,48029,Bexar,01073,Jefferson,AL,Birmingham,58,1917000,33051.724137931036,65,2206000,33938.46153846154,-7,-289000
2019,county,48453,Travis,22051,Jefferson Parish,LA,New Orleans,82,2406000,29341.463414634145,63,1706000,27079.365079365078,19,700000
2019,county,48029,Bexar,22051,Jefferson Parish,LA,New Orleans,104,2189000,21048.076923076922,47,1377000,29297.872340425532,57,812000
2019,county,48029,Bexar,48249,Jim Wells,TX,Rural Texas,157,4292000,27337.579617834395,91,2174000,23890.10989010989,66,2118000
2019,county,48491,Williamson,20091,Johnson,KS,Kansas City,62,2642000,42612.903225806454,33,2055000,62272.72727272727,29,587000
2019,county,48453,Travis,20091,Johnson,KS,Kansas City,106,11942000,112660.37735849057,66,1810000,27424.242424242424,40,10132000
2019,county,48453,Travis,48251,Johnson,TX,Dallas-Fort Worth,41,1164000,28390.243902439026,60,2167000,36116.666666666664,-19,-1003000
2019,county,48029,Bexar,20091,Johnson,KS,Kansas City,102,3360000,32941.17647058824,47,1581000,33638.29787234042,55,1779000
2019,county,48029,Bexar,48251,Johnson,TX,Dallas-Fort Worth,69,1394000,20202.898550724636,67,2561000,38223.880597014926,2,-1167000
2019,county,48029,Bexar,29101,Johnson,MO,Rural Missouri,58,1306000,22517.241379310344,44,1017000,23113.636363636364,14,289000
2019,county,48029,Bexar,48255,Karnes,TX,Rural Texas,105,6924000,65942.85714285714,77,1593000,20688.31168831169,28,5331000
2019,county,48453,Travis,48257,Kaufman,TX,Dallas-Fort Worth,37,1138000,30756.756756756757,32,933000,29156.25,5,205000
2019,county,48453,Travis,48259,Kendall,TX,Rural Texas,54,1952000,36148.148148148146,53,3529000,66584.90566037736,1,-1577000
2019,county,48091,Comal,48259,Kendall,TX,Rural Texas,190,11160000,58736.84210526316,147,13238000,90054.42176870749,43,-2078000
2019,county,48029,Bexar,48259,Kendall,TX,Rural Texas,997,45830000,45967.903711133404,1727,97161000,56259.988419224086,-730,-51331000
2019,county,48453,Travis,26081,Kent,MI,Rural Michigan,52,1998000,38423.07692307692,43,2663000,61930.232558139534,9,-665000
2019,county,48029,Bexar,10001,Kent,DE,Rural Delaware,77,1790000,23246.753246753247,58,1262000,21758.620689655174,19,528000
2019,county,48453,Travis,06029,Kern,CA,Rural California,71,2078000,29267.605633802817,39,905000,23205.128205128207,32,1173000
2019,county,48029,Bexar,06029,Kern,CA,Rural California,166,4862000,29289.156626506025,96,1917000,19968.75,70,2945000
2019,county,48453,Travis,48265,Kerr,TX,Rural Texas,98,3923000,40030.61224489796,91,3994000,43890.10989010989,7,-71000
2019,county,48029,Bexar,48265,Kerr,TX,Rural Texas,329,8998000,27349.544072948327,297,13356000,44969.69696969697,32,-4358000
2019,county,48491,Williamson,53033,King,WA,Seattle,345,20471000,59336.23188405797,213,11535000,54154.92957746479,132,8936000
2019,county,48453,Travis,53033,King,WA,Seattle,835,63439000,75974.8502994012,678,44633000,65830.38348082596,157,18806000
2019,county,48209,Hays,53033,King,WA,Seattle,47,1860000,39574.46808510638,49,3204000,65387.755102040814,-2,-1344000
2019,county,48029,Bexar,53033,King,WA,Seattle,289,11835000,40951.5570934256,321,14447000,45006.230529595014,-32,-2612000
2019,county,48453,Travis,36047,Kings,NY,New York,533,44597000,83671.66979362101,319,18742000,58752.35109717868,214,25855000
2019,county,48029,Bexar,36047,Kings,NY,New York,124,4741000,38233.87096774193,84,2984000,35523.80952380953,40,1757000
2019,county,48029,Bexar,53035,Kitsap,WA,Rural Washington,59,1556000,26372.881355932204,59,1336000,22644.06779661017,0,220000
2019,county,48029,Bexar,48273,Kleberg,TX,Rural Texas,104,2447000,23528.846153846152,59,1584000,26847.457627118645,45,863000
2019,county,48453,Travis,47093,Knox,TN,Knoxville,52,2074000,39884.61538461538,44,2321000,52750.0,8,-247000
2019,county,48029,Bexar,47093,Knox,TN,Knoxville,48,2126000,44291.666666666664,43,1587000,36906.976744186046,5,539000
2019,county,48453,Travis,22055,Lafayette Parish,LA,Rural Louisiana,80,3196000,39950.0,30,600000,20000.0,50,2596000
2019,county,48029,Bexar,22055,Lafayette Parish,LA,Rural Louisiana,81,1814000,22395.061728395063,48,1444000,30083.333333333332,33,370000
2019,county,48453,Travis,17097,Lake,IL,Chicago,129,9163000,71031.00775193798,47,3540000,75319.14893617021,82,5623000
2019,county,48029,Bexar,17097,Lake,IL,Chicago,132,3671000,27810.60606060606,72,2326000,32305.555555555555,60,1345000
2019,county,48029,Bexar,18089,Lake,IN,Rural Indiana,64,1713000,26765.625,55,783000,14236.363636363636,9,930000
2019,county,48491,Williamson,48281,Lampasas,TX,Rural Texas,56,1647000,29410.714285714286,160,4840000,30250.0,-104,-3193000
2019,county,48453,Travis,48281,Lampasas,TX,Rural Texas,45,1072000,23822.222222222223,66,2711000,41075.757575757576,-21,-1639000
2019,county,48453,Travis,41039,Lane,OR,Rural Oregon,47,1828000,38893.617021276594,69,2107000,30536.231884057972,-22,-279000
2019,county,48029,Bexar,56021,Laramie,WY,Rural Wyoming,77,2112000,27428.571428571428,71,1760000,24788.732394366198,6,352000
2019,county,48491,Williamson,08069,Larimer,CO,Rural Colorado,48,2467000,51395.833333333336,51,2227000,43666.666666666664,-3,240000
2019,county,48453,Travis,08069,Larimer,CO,Rural Colorado,91,3845000,42252.74725274725,104,5698000,54788.46153846154,-13,-1853000
2019,county,48029,Bexar,08069,Larimer,CO,Rural Colorado,48,1557000,32437.5,87,4120000,47356.32183908046,-39,-2563000
2019,county,48491,Williamson,48287,Lee,TX,Rural Texas,46,1428000,31043.478260869564,78,2025000,25961.53846153846,-32,-597000
2019,county,48453,Travis,12071,Lee,FL,S.W. Florida,71,3671000,51704.22535211268,66,3653000,55348.48484848485,5,18000
2019,county,48453,Travis,48287,Lee,TX,Rural Texas,72,1847000,25652.777777777777,92,2664000,28956.521739130436,-20,-817000
2019,county,48029,Bexar,12071,Lee,FL,S.W. Florida,55,1614000,29345.454545454544,60,1503000,25050.0,-5,111000
2019,county,48453,Travis,12073,Leon,FL,Rural Florida,60,2337000,38950.0,36,1022000,28388.88888888889,24,1315000
2019,county,48029,Bexar,13179,Liberty,GA,Rural Georgia,69,1105000,16014.492753623188,71,1136000,16000.0,-2,-31000
2019,county,48491,Williamson,48299,Llano,TX,Rural Texas,76,4355000,57302.63157894737,74,3984000,53837.83783783784,2,371000
2019,county,48453,Travis,48299,Llano,TX,Rural Texas,85,4641000,54600.0,176,14240000,80909.09090909091,-91,-9599000
2019,county,48029,Bexar,48299,Llano,TX,Rural Texas,38,1279000,33657.89473684211,58,6422000,110724.13793103448,-20,-5143000
2019,county,48491,Williamson,06037,Los Angeles,CA,Los Angeles,601,26008000,43274.54242928453,159,6660000,41886.79245283019,442,19348000
2019,county,48453,Travis,06037,Los Angeles,CA,Los Angeles,1626,122321000,75228.16728167281,928,69484000,74875.0,698,52837000
2019,county,48209,Hays,06037,Los Angeles,CA,Los Angeles,132,8109000,61431.818181818184,43,1758000,40883.72093023256,89,6351000
2019,county,48029,Bexar,06037,Los Angeles,CA,Los Angeles,1152,35392000,30722.222222222223,582,33096000,56865.9793814433,570,2296000
2019,county,48029,Bexar,51107,Loudoun,VA,Rural Virginia,137,8038000,58671.53284671533,90,4366000,48511.11111111111,47,3672000
2019,county,48029,Bexar,13185,Lowndes,GA,Rural Georgia,73,1489000,20397.260273972603,64,1458000,22781.25,9,31000
2019,county,48491,Williamson,48303,Lubbock,TX,Rural Texas,210,7468000,35561.90476190476,97,3316000,34185.56701030928,113,4152000
2019,county,48453,Travis,48303,Lubbock,TX,Rural Texas,308,10837000,35185.06493506493,161,5202000,32310.55900621118,147,5635000
2019,county,48209,Hays,48303,Lubbock,TX,Rural Texas,59,1755000,29745.762711864405,42,1257000,29928.571428571428,17,498000
2019,county,48091,Comal,48303,Lubbock,TX,Rural Texas,59,2396000,40610.16949152543,38,931000,24500.0,21,1465000
2019,county,48029,Bexar,48303,Lubbock,TX,Rural Texas,318,8487000,26688.67924528302,218,5579000,25591.743119266055,100,2908000
2019,county,48453,Travis,01089,Madison,AL,Huntsville,51,2833000,55549.01960784314,31,1210000,39032.25806451613,20,1623000
2019,county,48029,Bexar,01089,Madison,AL,Huntsville,54,1524000,28222.222222222223,70,1947000,27814.285714285714,-16,-423000
2019,county,48453,Travis,12081,Manatee,FL,Rural Florida,44,1727000,39250.0,39,1715000,43974.35897435898,5,12000
2019,county,48491,Williamson,04013,Maricopa,AZ,Phoenix,481,19942000,41459.45945945946,289,12891000,44605.53633217993,192,7051000
2019,county,48453,Travis,04013,Maricopa,AZ,Phoenix,707,49208000,69601.1315417256,544,27707000,50931.98529411765,163,21501000
2019,county,48209,Hays,04013,Maricopa,AZ,Phoenix,51,2127000,41705.882352941175,63,2473000,39253.968253968254,-12,-346000
2019,county,48091,Comal,04013,Maricopa,AZ,Phoenix,74,3128000,42270.27027027027,39,1978000,50717.94871794872,35,1150000
2019,county,48029,Bexar,04013,Maricopa,AZ,Phoenix,762,24361000,31969.81627296588,742,30322000,40865.229110512126,20,-5961000
2019,county,48453,Travis,06041,Marin,CA,Bay Area,108,18601000,172231.4814814815,56,5177000,92446.42857142857,52,13424000
2019,county,48453,Travis,18097,Marion,IN,Indianapolis,132,7354000,55712.121212121216,65,2350000,36153.846153846156,67,5004000
2019,county,48029,Bexar,18097,Marion,IN,Indianapolis,130,3130000,24076.923076923078,91,2324000,25538.46153846154,39,806000
2019,county,48453,Travis,48323,Maverick,TX,Rural Texas,52,1036000,19923.076923076922,58,1310000,22586.206896551725,-6,-274000
2019,county,48029,Bexar,48323,Maverick,TX,Rural Texas,543,10993000,20244.935543278083,386,6366000,16492.227979274612,157,4627000
2019,county,48491,Williamson,48309,McLennan,TX,Rural Texas,235,6840000,29106.382978723403,249,6912000,27759.036144578313,-14,-72000
2019,county,48453,Travis,48309,McLennan,TX,Rural Texas,325,12193000,37516.92307692308,287,9300000,32404.18118466899,38,2893000
2019,county,48209,Hays,48309,McLennan,TX,Rural Texas,42,1285000,30595.238095238095,47,1170000,24893.617021276597,-5,115000
2019,county,48091,Comal,48309,McLennan,TX,Rural Texas,64,1851000,28921.875,34,1350000,39705.882352941175,30,501000
2019,county,48029,Bexar,48309,McLennan,TX,Rural Texas,223,4879000,21878.923766816144,230,6145000,26717.391304347828,-7,-1266000
2019,county,48491,Williamson,37119,Mecklenburg,NC,Charlotte,76,4197000,55223.68421052631,48,1991000,41479.166666666664,28,2206000
2019,county,48453,Travis,37119,Mecklenburg,NC,Charlotte,218,18788000,86183.4862385321,176,11557000,65664.77272727272,42,7231000
2019,county,48029,Bexar,37119,Mecklenburg,NC,Charlotte,155,7076000,45651.6129032258,125,5717000,45736.0,30,1359000
2019,county,48029,Bexar,48325,Medina,TX,Rural Texas,1285,32704000,25450.583657587547,1514,43555000,28768.163804491414,-229,-10851000
2019,county,48453,Travis,34021,Mercer,NJ,Rural New Jersey,49,2934000,59877.551020408166,28,907000,32392.85714285714,21,2027000
2019,county,48491,Williamson,12086,Miami-Dade,FL,Miami,181,3330000,18397.790055248617,57,1430000,25087.719298245614,124,1900000
2019,county,48453,Travis,12086,Miami-Dade,FL,Miami,459,19798000,43132.89760348584,315,9232000,29307.93650793651,144,10566000
2019,county,48029,Bexar,12086,Miami-Dade,FL,Miami,290,9824000,33875.862068965514,223,6130000,27488.789237668163,67,3694000
2019,county,48453,Travis,25017,Middlesex,MA,Boston,344,24917000,72433.13953488372,237,16732000,70599.15611814347,107,8185000
2019,county,48453,Travis,34023,Middlesex,NJ,New York,110,5997000,54518.181818181816,68,2905000,42720.58823529412,42,3092000
2019,county,48029,Bexar,25017,Middlesex,MA,Boston,135,5056000,37451.851851851854,100,4320000,43200.0,35,736000
2019,county,48491,Williamson,48329,Midland,TX,Rural Texas,103,10477000,101718.44660194175,65,2578000,39661.53846153846,38,7899000
2019,county,48453,Travis,48329,Midland,TX,Rural Texas,171,11412000,66736.84210526316,110,6014000,54672.72727272727,61,5398000
2019,county,48091,Comal,48329,Midland,TX,Rural Texas,86,4420000,51395.348837209305,56,2728000,48714.28571428572,30,1692000
2019,county,48029,Bexar,48329,Midland,TX,Rural Texas,365,13411000,36742.46575342466,289,10970000,37958.47750865052,76,2441000
2019,county,48491,Williamson,48331,Milam,TX,Rural Texas,235,5765000,24531.91489361702,294,7111000,24187.07482993197,-59,-1346000
2019,county,48453,Travis,48331,Milam,TX,Rural Texas,89,2469000,27741.573033707864,94,2174000,23127.659574468085,-5,295000
2019,county,48453,Travis,55079,Milwaukee,WI,Milwaukee,142,6469000,45556.33802816901,53,1868000,35245.28301886792,89,4601000
2019,county,48029,Bexar,55079,Milwaukee,WI,Milwaukee,104,2023000,19451.923076923078,141,2343000,16617.021276595744,-37,-320000
2019,county,48453,Travis,36055,Monroe,NY,Rochester,85,3219000,37870.58823529412,26,838000,32230.76923076923,59,2381000
2019,county,48029,Bexar,36055,Monroe,NY,Rochester,44,1366000,31045.454545454544,39,1113000,28538.46153846154,5,253000
2019,county,48453,Travis,06053,Monterey,CA,Rural California,63,4749000,75380.95238095238,52,3082000,59269.230769230766,11,1667000
2019,county,48029,Bexar,06053,Monterey,CA,Rural California,147,3846000,26163.26530612245,89,2042000,22943.8202247191,58,1804000
2019,county,48491,Williamson,48339,Montgomery,TX,Houston,252,10273000,40765.87301587302,198,7605000,38409.09090909091,54,2668000
2019,county,48453,Travis,48339,Montgomery,TX,Houston,464,62954000,135676.72413793104,389,16168000,41562.98200514139,75,46786000
2019,county,48453,Travis,24031,Montgomery,MD,D.C.,183,10405000,56857.92349726776,98,5001000,51030.61224489796,85,5404000
2019,county,48453,Travis,42091,Montgomery,PA,Philadelphia,69,4158000,60260.86956521739,48,1897000,39520.833333333336,21,2261000
2019,county,48209,Hays,48339,Montgomery,TX,Houston,130,14331000,110238.46153846153,109,3478000,31908.256880733945,21,10853000
2019,county,48091,Comal,48339,Montgomery,TX,Houston,142,8487000,59767.605633802814,54,2689000,49796.2962962963,88,5798000
2019,county,48029,Bexar,48339,Montgomery,TX,Houston,308,11416000,37064.93506493507,406,14927000,36766.00985221675,-98,-3511000
2019,county,48029,Bexar,24031,Montgomery,MD,D.C.,247,11925000,48279.35222672065,232,9475000,40840.51724137931,15,2450000
2019,county,48029,Bexar,47125,Montgomery,TN,Rural Tennessee,179,3844000,21474.86033519553,155,3029000,19541.935483870966,24,815000
2019,county,48029,Bexar,39113,Montgomery,OH,Rural Ohio,116,4363000,37612.06896551724,181,5054000,27922.651933701658,-65,-691000
2019,county,48029,Bexar,01101,Montgomery,AL,Montgomery,78,2337000,29961.53846153846,92,2704000,29391.304347826088,-14,-367000
2019,county,48491,Williamson,41051,Multnomah,OR,Portland,42,1318000,31380.95238095238,27,1071000,39666.666666666664,15,247000
2019,county,48453,Travis,41051,Multnomah,OR,Portland,207,10562000,51024.15458937198,224,20029000,89415.17857142857,-17,-9467000
2019,county,48029,Bexar,41051,Multnomah,OR,Portland,55,3120000,56727.27272727273,122,8502000,69688.52459016393,-67,-5382000
2019,county,48029,Bexar,13215,Muscogee,GA,Columbus,120,2422000,20183.333333333332,91,1616000,17758.24175824176,29,806000
2019,county,48453,Travis,48347,Nacogdoches,TX,Rural Texas,53,1062000,20037.735849056604,32,661000,20656.25,21,401000
2019,county,48453,Travis,09009,New Haven,CT,New Haven,71,3320000,46760.56338028169,39,3490000,89487.17948717948,32,-170000
2019,county,48491,Williamson,36061,New York,NY,New York,45,3573000,79400.0,26,1478000,56846.153846153844,19,2095000
2019,county,48453,Travis,36061,New York,NY,New York,486,95714000,196942.3868312757,352,30044000,85352.27272727272,134,65670000
2019,county,48029,Bexar,36061,New York,NY,New York,100,6315000,63150.0,93,5281000,56784.94623655914,7,1034000
2019,county,48029,Bexar,51700,Newport News city,VA,Hampton Roads,120,2505000,20875.0,75,1521000,20280.0,45,984000
2019,county,48453,Travis,25021,Norfolk,MA,Boston,102,6745000,66127.45098039215,72,5617000,78013.88888888889,30,1128000
2019,county,48029,Bexar,51710,Norfolk city,VA,Hampton Roads,117,2555000,21837.606837606836,120,2159000,17991.666666666668,-3,396000
2019,county,48491,Williamson,48355,Nueces,TX,Rural Texas,208,5591000,26879.80769230769,141,5492000,38950.354609929076,67,99000
2019,county,48453,Travis,48355,Nueces,TX,Rural Texas,400,13446000,33615.0,323,10849000,33588.23529411765,77,2597000
2019,county,48209,Hays,48355,Nueces,TX,Rural Texas,126,3998000,31730.15873015873,89,2840000,31910.112359550563,37,1158000
2019,county,48091,Comal,48355,Nueces,TX,Rural Texas,193,7600000,39378.238341968914,94,4086000,43468.085106382976,99,3514000
2019,county,48029,Bexar,48355,Nueces,TX,Rural Texas,1319,45728000,34668.68840030326,1029,28261000,27464.528668610303,290,17467000
2019,county,48453,Travis,26125,Oakland,MI,Detroit,177,12616000,71276.83615819209,76,3786000,49815.78947368421,101,8830000
2019,county,48029,Bexar,26125,Oakland,MI,Detroit,125,4384000,35072.0,72,2697000,37458.333333333336,53,1687000
2019,county,48453,Travis,12091,Okaloosa,FL,FL Panhandle,48,2202000,45875.0,29,1101000,37965.51724137931,19,1101000
2019,county,48029,Bexar,12091,Okaloosa,FL,FL Panhandle,266,6799000,25560.15037593985,260,7338000,28223.076923076922,6,-539000
2019,county,48491,Williamson,40109,Oklahoma,OK,Oklahoma City,72,2267000,31486.11111111111,70,2438000,34828.57142857143,2,-171000
2019,county,48453,Travis,40109,Oklahoma,OK,Oklahoma City,145,5559000,38337.93103448276,155,11094000,71574.19354838709,-10,-5535000
2019,county,48029,Bexar,40109,Oklahoma,OK,Oklahoma City,241,6838000,28373.44398340249,199,8081000,40608.040201005024,42,-1243000
2019,county,48029,Bexar,37133,Onslow,NC,Rural North Carolina,181,2760000,15248.618784530387,147,2664000,18122.448979591838,34,96000
2019,county,48491,Williamson,06059,Orange,CA,Los Angeles,455,19112000,42004.395604395606,119,6033000,50697.47899159664,336,13079000
2019,county,48491,Williamson,12095,Orange,FL,Orlando,131,2668000,20366.41221374046,67,2397000,35776.119402985074,64,271000
2019,county,48453,Travis,06059,Orange,CA,Los Angeles,704,60911000,86521.30681818182,283,18019000,63671.37809187279,421,42892000
2019,county,48453,Travis,12095,Orange,FL,Orlando,234,7572000,32358.97435897436,161,6533000,40577.63975155279,73,1039000
2019,county,48453,Travis,37135,Orange,NC,Raleigh,35,2168000,61942.857142857145,41,4809000,117292.68292682926,-6,-2641000
2019,county,48029,Bexar,06059,Orange,CA,Los Angeles,458,17767000,38792.576419213976,197,6892000,34984.77157360406,261,10875000
2019,county,48029,Bexar,12095,Orange,FL,Orlando,191,5569000,29157.068062827224,186,4920000,26451.612903225807,5,649000
2019,county,48453,Travis,22071,Orleans Parish,LA,New Orleans,138,8262000,59869.565217391304,91,4452000,48923.07692307692,47,3810000
2019,county,48029,Bexar,22071,Orleans Parish,LA,New Orleans,104,3342000,32134.615384615383,52,1316000,25307.69230769231,52,2026000
2019,county,48029,Bexar,12097,Osceola,FL,Orlando,67,1265000,18880.597014925374,73,1485000,20342.465753424658,-6,-220000
2019,county,48029,Bexar,35035,Otero,NM,Rural New Mexico,85,2052000,24141.176470588234,118,2996000,25389.830508474577,-33,-944000
2019,county,48491,Williamson,12099,Palm Beach,FL,Miami,83,2560000,30843.373493975905,63,2407000,38206.34920634921,20,153000
2019,county,48453,Travis,12099,Palm Beach,FL,Miami,233,10518000,45141.63090128756,149,5301000,35577.18120805369,84,5217000
2019,county,48029,Bexar,12099,Palm Beach,FL,Miami,83,3163000,38108.43373493976,120,5137000,42808.333333333336,-37,-1974000
2019,county,48453,Travis,48367,Parker,TX,Dallas-Fort Worth,45,1913000,42511.11111111111,53,4297000,81075.47169811321,-8,-2384000
2019,county,48029,Bexar,48367,Parker,TX,Dallas-Fort Worth,47,1773000,37723.40425531915,85,3319000,39047.05882352941,-38,-1546000
2019,county,48029,Bexar,12101,Pasco,FL,Tampa,62,1612000,26000.0,76,2042000,26868.42105263158,-14,-430000
2019,county,48453,Travis,42101,Philadelphia,PA,Philadelphia,122,6040000,49508.19672131148,130,6936000,53353.846153846156,-8,-896000
2019,county,48029,Bexar,42101,Philadelphia,PA,Philadelphia,84,3751000,44654.76190476191,50,1682000,33640.0,34,2069000
2019,county,48491,Williamson,53053,Pierce,WA,Seattle,89,2681000,30123.595505617977,76,2077000,27328.947368421053,13,604000
2019,county,48453,Travis,53053,Pierce,WA,Seattle,102,3111000,30500.0,89,2565000,28820.224719101123,13,546000
2019,county,48029,Bexar,53053,Pierce,WA,Seattle,435,11136000,25600.0,290,6472000,22317.241379310344,145,4664000
2019,county,48491,Williamson,04019,Pima,AZ,Tucson,78,2485000,31858.97435897436,40,1563000,39075.0,38,922000
2019,county,48453,Travis,04019,Pima,AZ,Tucson,121,4140000,34214.87603305785,124,4434000,35758.06451612903,-3,-294000
2019,county,48029,Bexar,04019,Pima,AZ,Tucson,288,7698000,26729.166666666668,201,6058000,30139.303482587064,87,1640000
2019,county,48453,Travis,12103,Pinellas,FL,Tampa,120,5598000,46650.0,123,6551000,53260.16260162602,-3,-953000
2019,county,48029,Bexar,12103,Pinellas,FL,Tampa,83,2982000,35927.7108433735,100,4115000,41150.0,-17,-1133000
2019,county,48029,Bexar,06061,Placer,CA,Sacramento,84,3455000,41130.95238095238,65,1837000,28261.53846153846,19,1618000
2019,county,48491,Williamson,48373,Polk,TX,Rural Texas,54,1593000,29500.0,58,2677000,46155.1724137931,-4,-1084000
2019,county,48453,Travis,12105,Polk,FL,Orlando,56,1341000,23946.428571428572,72,1493000,20736.11111111111,-16,-152000
2019,county,48453,Travis,48373,Polk,TX,Rural Texas,39,2536000,65025.64102564102,63,2487000,39476.19047619047,-24,49000
2019,county,48029,Bexar,19153,Polk,IA,Rural Iowa,65,2268000,34892.307692307695,42,657000,15642.857142857143,23,1611000
2019,county,48029,Bexar,12105,Polk,FL,Orlando,63,1599000,25380.95238095238,37,1073000,29000.0,26,526000
2019,county,48453,Travis,48375,Potter,TX,Rural Texas,51,958000,18784.313725490196,36,1668000,46333.333333333336,15,-710000
2019,county,48029,Bexar,48375,Potter,TX,Rural Texas,80,1537000,19212.5,57,1228000,21543.859649122805,23,309000
2019,county,48453,Travis,24033,Prince George,MD,Rural Maryland,66,2511000,38045.454545454544,54,1350000,25000.0,12,1161000
2019,county,48029,Bexar,24033,Prince George,MD,Rural Maryland,162,6245000,38549.38271604938,140,4560000,32571.428571428572,22,1685000
2019,county,48029,Bexar,51153,Prince William,VA,Rural Virginia,150,5899000,39326.666666666664,136,4096000,30117.647058823528,14,1803000
2019,county,48453,Travis,44007,Providence,RI,Providence,34,1821000,53558.82352941176,37,2417000,65324.32432432433,-3,-596000
2019,county,48453,Travis,05119,Pulaski,AR,Little Rock,91,3723000,40912.08791208791,59,2143000,36322.03389830508,32,1580000
2019,county,48029,Bexar,05119,Pulaski,AR,Little Rock,96,2959000,30822.916666666668,87,2464000,28321.83908045977,9,495000
2019,county,48453,Travis,36081,Queens,NY,New York,210,10550000,50238.09523809524,111,4700000,42342.342342342345,99,5850000
2019,county,48029,Bexar,36081,Queens,NY,New York,88,1913000,21738.636363636364,61,1939000,31786.885245901638,27,-26000
2019,county,48453,Travis,27123,Ramsey,MN,Minneapolis,65,2803000,43123.07692307692,41,1780000,43414.634146341465,24,1023000
2019,county,48453,Travis,48381,Randall,TX,Rural Texas,68,4245000,62426.470588235294,54,1754000,32481.48148148148,14,2491000
2019,county,48029,Bexar,48381,Randall,TX,Rural Texas,98,3121000,31846.938775510203,87,2693000,30954.02298850575,11,428000
2019,county,48029,Bexar,45079,Richland,SC,Columbia,96,2137000,22260.416666666668,73,1705000,23356.164383561645,23,432000
2019,county,48029,Bexar,13245,Richmond,GA,Rural Georgia,103,2421000,23504.85436893204,94,2129000,22648.936170212764,9,292000
2019,county,48453,Travis,51760,Richmond city,VA,Richmond,41,1943000,47390.243902439026,38,2160000,56842.10526315789,3,-217000
2019,county,48029,Bexar,20161,Riley,KS,Rural Kansas,67,1310000,19552.238805970148,68,2111000,31044.117647058825,-1,-801000
2019,county,48491,Williamson,06065,Riverside,CA,San Bernardino-Riverside,283,8385000,29628.975265017667,72,2191000,30430.555555555555,211,6194000
2019,county,48453,Travis,06065,Riverside,CA,San Bernardino-Riverside,248,11800000,47580.645161290326,143,3554000,24853.146853146853,105,8246000
2019,county,48029,Bexar,06065,Riverside,CA,San Bernardino-Riverside,397,10803000,27211.586901763225,211,4611000,21853.08056872038,186,6192000
2019,county,48453,Travis,48397,Rockwall,TX,Dallas-Fort Worth,44,2082000,47318.181818181816,57,2762000,48456.14035087719,-13,-680000
2019,county,48029,Bexar,48397,Rockwall,TX,Dallas-Fort Worth,37,1363000,36837.83783783784,56,1805000,32232.14285714286,-19,-442000
2019,county,48453,Travis,06067,Sacramento,CA,Sacramento,218,12874000,59055.04587155963,83,3365000,40542.1686746988,135,9509000
2019,county,48029,Bexar,06067,Sacramento,CA,Sacramento,199,6716000,33748.74371859297,116,2676000,23068.96551724138,83,4040000
2019,county,48491,Williamson,49035,Salt Lake,UT,Salt Lake,89,4459000,50101.12359550562,84,2904000,34571.42857142857,5,1555000
2019,county,48453,Travis,49035,Salt Lake,UT,Salt Lake,216,11849000,54856.48148148148,121,6822000,56380.1652892562,95,5027000
2019,county,48029,Bexar,49035,Salt Lake,UT,Salt Lake,212,5658000,26688.67924528302,127,4074000,32078.740157480315,85,1584000
2019,county,48491,Williamson,06071,San Bernardino,CA,San Bernardino-Riverside,165,5892000,35709.09090909091,51,1310000,25686.274509803923,114,4582000
2019,county,48453,Travis,06071,San Bernardino,CA,San Bernardino-Riverside,123,3577000,29081.30081300813,79,2283000,28898.73417721519,44,1294000
2019,county,48029,Bexar,06071,San Bernardino,CA,San Bernardino-Riverside,381,9695000,25446.194225721785,230,4133000,17969.565217391304,151,5562000
2019,county,48491,Williamson,06073,San Diego,CA,San Diego,491,20576000,41906.31364562118,144,4600000,31944.444444444445,347,15976000
2019,county,48453,Travis,06073,San Diego,CA,San Diego,870,55428000,63710.34482758621,398,26966000,67753.76884422111,472,28462000
2019,county,48209,Hays,06073,San Diego,CA,San Diego,134,4926000,36761.19402985075,43,2163000,50302.32558139535,91,2763000
2019,county,48029,Bexar,06073,San Diego,CA,San Diego,1037,29812000,28748.31243972999,576,15310000,26579.86111111111,461,14502000
2019,county,48453,Travis,06075,San Francisco,CA,Bay Area,552,115949000,210052.53623188406,282,31914000,113170.21276595745,270,84035000
2019,county,48029,Bexar,06075,San Francisco,CA,Bay Area,57,4150000,72807.01754385965,40,2973000,74325.0,17,1177000
2019,county,48453,Travis,06081,San Mateo,CA,Bay Area,356,65599000,184266.85393258426,151,12710000,84172.18543046358,205,52889000
2019,county,48029,Bexar,06081,San Mateo,CA,Bay Area,39,2337000,59923.07692307692,39,1973000,50589.743589743586,0,364000
2019,county,48453,Travis,48409,San Patricio,TX,Rural Texas,61,1673000,27426.22950819672,57,1295000,22719.298245614034,4,378000
2019,county,48029,Bexar,48409,San Patricio,TX,Rural Texas,178,4862000,27314.606741573032,120,2729000,22741.666666666668,58,2133000
2019,county,48453,Travis,06083,Santa Barbara,CA,Rural California,109,7890000,72385.32110091743,72,7312000,101555.55555555556,37,578000
2019,county,48029,Bexar,06083,Santa Barbara,CA,Rural California,110,2290000,20818.18181818182,45,1097000,24377.777777777777,65,1193000
2019,county,48491,Williamson,06085,Santa Clara,CA,Bay Area,871,65983000,75755.45350172216,156,10049000,64416.666666666664,715,55934000
2019,county,48453,Travis,06085,Santa Clara,CA,Bay Area,1370,132899000,97006.5693430657,550,48429000,88052.72727272728,820,84470000
2019,county,48029,Bexar,06085,Santa Clara,CA,Bay Area,216,9522000,44083.333333333336,133,6857000,51556.39097744361,83,2665000
2019,county,48453,Travis,35049,Santa Fe,NM,Rural New Mexico,46,2055000,44673.913043478264,87,5851000,67252.8735632184,-41,-3796000
2019,county,48029,Bexar,12113,Santa Rosa,FL,FL Panhandle,122,2880000,23606.55737704918,70,1682000,24028.571428571428,52,1198000
2019,county,48453,Travis,12115,Sarasota,FL,S.W. Florida,45,2277000,50600.0,35,1777000,50771.42857142857,10,500000
2019,county,48029,Bexar,31153,Sarpy,NE,Omaha,131,3311000,25274.809160305344,121,2695000,22272.727272727272,10,616000
2019,county,48453,Travis,20173,Sedgwick,KS,Rural Kansas,45,3221000,71577.77777777778,49,1376000,28081.632653061224,-4,1845000
2019,county,48029,Bexar,20173,Sedgwick,KS,Rural Kansas,129,4375000,33914.72868217054,84,2371000,28226.190476190477,45,2004000
2019,county,48453,Travis,12117,Seminole,FL,Orlando,62,3984000,64258.06451612903,33,873000,26454.545454545456,29,3111000
2019,county,48029,Bexar,12117,Seminole,FL,Orlando,62,1228000,19806.451612903227,46,2144000,46608.69565217391,16,-916000
2019,county,48453,Travis,47157,Shelby,TN,Memphis,129,4535000,35155.03875968992,76,4917000,64697.36842105263,53,-382000
2019,county,48029,Bexar,47157,Shelby,TN,Memphis,141,4227000,29978.72340425532,157,6608000,42089.171974522294,-16,-2381000
2019,county,48491,Williamson,48423,Smith,TX,Rural Texas,104,3612000,34730.769230769234,86,2472000,28744.18604651163,18,1140000
2019,county,48453,Travis,48423,Smith,TX,Rural Texas,143,6484000,45342.657342657345,183,7485000,40901.639344262294,-40,-1001000
2019,county,48029,Bexar,48423,Smith,TX,Rural Texas,132,2750000,20833.333333333332,129,3467000,26875.96899224806,3,-717000
2019,county,48453,Travis,53061,Snohomish,WA,Seattle,145,7385000,50931.03448275862,78,5339000,68448.71794871795,67,2046000
2019,county,48029,Bexar,53061,Snohomish,WA,Seattle,144,6032000,41888.88888888889,94,2382000,25340.425531914894,50,3650000
2019,county,48029,Bexar,06095,Solano,CA,Bay Area,186,5415000,29112.90322580645,180,4160000,23111.11111111111,6,1255000
2019,county,48453,Travis,53063,Spokane,WA,Spokane,55,2401000,43654.545454545456,29,999000,34448.275862068964,26,1402000
2019,county,48029,Bexar,53063,Spokane,WA,Spokane,108,3100000,28703.703703703704,89,2698000,30314.606741573032,19,402000
2019,county,48029,Bexar,17163,St. Clair,IL,St. Louis,201,4892000,24338.308457711442,132,3213000,24340.909090909092,69,1679000
2019,county,48453,Travis,12109,St. Johns,FL,Jacksonville,50,1715000,34300.0,40,2386000,59650.0,10,-671000
2019,county,48453,Travis,29189,St. Louis,MO,St. Louis,160,11248000,70300.0,88,3421000,38875.0,72,7827000
2019,county,48029,Bexar,29189,St. Louis,MO,St. Louis,110,3291000,29918.18181818182,59,2521000,42728.813559322036,51,770000
2019,county,48453,Travis,29510,St. Louis city,MO,Rural Missouri,51,3175000,62254.901960784315,49,1878000,38326.5306122449,2,1297000
2019,county,48029,Bexar,29510,St. Louis city,MO,Rural Missouri,42,1592000,37904.76190476191,32,850000,26562.5,10,742000
2019,county,48453,Travis,22103,St. Tammany Parish,LA,New Orleans,58,2875000,49568.96551724138,36,1331000,36972.22222222222,22,1544000
2019,county,48029,Bexar,22103,St. Tammany Parish,LA,New Orleans,86,2405000,27965.116279069767,39,1170000,30000.0,47,1235000
2019,county,48029,Bexar,51179,Stafford,VA,Rural Virginia,65,1717000,26415.384615384617,69,1911000,27695.652173913044,-4,-194000
2019,county,48029,Bexar,48427,Starr,TX,Rural Texas,48,1052000,21916.666666666668,61,1236000,20262.29508196721,-13,-184000
2019,county,48453,Travis,25025,Suffolk,MA,Boston,190,16289000,85731.57894736843,105,7478000,71219.04761904762,85,8811000
2019,county,48453,Travis,36103,Suffolk,NY,New York,119,8340000,70084.03361344538,53,2297000,43339.622641509435,66,6043000
2019,county,48029,Bexar,36103,Suffolk,NY,New York,77,2147000,27883.116883116883,29,930000,32068.96551724138,48,1217000
2019,county,48029,Bexar,25025,Suffolk,MA,Boston,41,1706000,41609.756097560974,44,2477000,56295.454545454544,-3,-771000
2019,county,48029,Bexar,45085,Sumter,SC,Rural South Carolina,72,1369000,19013.88888888889,57,1364000,23929.824561403508,15,5000
2019,county,48491,Williamson,48439,Tarrant,TX,Dallas-Fort Worth,574,21937000,38217.770034843204,488,18790000,38504.098360655735,86,3147000
2019,county,48453,Travis,48439,Tarrant,TX,Dallas-Fort Worth,1172,64659000,55169.795221843,900,40125000,44583.333333333336,272,24534000
2019,county,48209,Hays,48439,Tarrant,TX,Dallas-Fort Worth,188,8925000,47473.40425531915,151,4178000,27668.87417218543,37,4747000
2019,county,48091,Comal,48439,Tarrant,TX,Dallas-Fort Worth,128,5147000,40210.9375,102,6771000,66382.35294117648,26,-1624000
2019,county,48029,Bexar,48439,Tarrant,TX,Dallas-Fort Worth,1098,33982000,30948.998178506376,1251,38286000,30604.31654676259,-153,-4304000
2019,county,48491,Williamson,48441,Taylor,TX,Rural Texas,86,3131000,36406.976744186046,64,1663000,25984.375,22,1468000
2019,county,48453,Travis,48441,Taylor,TX,Rural Texas,138,4122000,29869.565217391304,78,3062000,39256.41025641026,60,1060000
2019,county,48029,Bexar,48441,Taylor,TX,Rural Texas,268,5672000,21164.17910447761,127,2731000,21503.937007874014,141,2941000
2019,county,48453,Travis,53067,Thurston,WA,Rural Washington,46,1990000,43260.86956521739,30,1178000,39266.666666666664,16,812000
2019,county,48029,Bexar,53067,Thurston,WA,Rural Washington,106,2908000,27433.962264150945,112,2283000,20383.928571428572,-6,625000
2019,county,48491,Williamson,48451,Tom Green,TX,Rural Texas,71,2058000,28985.915492957745,54,1895000,35092.59259259259,17,163000
2019,county,48453,Travis,48451,Tom Green,TX,Rural Texas,116,3471000,29922.41379310345,89,4872000,54741.573033707864,27,-1401000
2019,county,48029,Bexar,48451,Tom Green,TX,Rural Texas,395,10409000,26351.898734177215,228,6391000,28030.701754385966,167,4018000
2019,county,48491,Williamson,48453,Travis,TX,Austin,19847,746532000,37614.34977578475,13631,503426000,36932.43342381337,6216,243106000
2019,county,48209,Hays,48453,Travis,TX,Austin,7751,300117000,38719.778093149274,3956,233752000,59087.967644084936,3795,66365000
2019,county,48091,Comal,48453,Travis,TX,Austin,464,22746000,49021.55172413793,361,19637000,54396.12188365651,103,3109000
2019,county,48029,Bexar,48453,Travis,TX,Austin,2230,88050000,39484.304932735424,2691,114493000,42546.636937941286,-461,-26443000
2019,county,48491,Williamson,40143,Tulsa,OK,Tulsa,86,2923000,33988.37209302326,55,1719000,31254.545454545456,31,1204000
2019,county,48453,Travis,40143,Tulsa,OK,Tulsa,117,5104000,43623.931623931625,82,3900000,47560.9756097561,35,1204000
2019,county,48029,Bexar,40143,Tulsa,OK,Tulsa,121,3415000,28223.14049586777,153,4848000,31686.274509803923,-32,-1433000
2019,county,48453,Travis,49049,Utah,UT,Rural Utah,135,3695000,27370.37037037037,62,2902000,46806.45161290323,73,793000
2019,county,48029,Bexar,49049,Utah,UT,Rural Utah,104,2241000,21548.076923076922,138,3024000,21913.043478260868,-34,-783000
2019,county,48029,Bexar,48463,Uvalde,TX,Rural Texas,255,6270000,24588.235294117647,126,3513000,27880.95238095238,129,2757000
2019,county,48029,Bexar,48465,Val Verde,TX,Rural Texas,320,10441000,32628.125,243,4943000,20341.56378600823,77,5498000
2019,county,48453,Travis,06111,Ventura,CA,Los Angeles,146,11506000,78808.21917808219,59,2208000,37423.72881355932,87,9298000
2019,county,48029,Bexar,06111,Ventura,CA,Los Angeles,137,4508000,32905.109489051094,64,1731000,27046.875,73,2777000
2019,county,48029,Bexar,22115,Vernon Parish,LA,Rural Louisiana,122,2450000,20081.967213114753,72,1201000,16680.555555555555,50,1249000
2019,county,48491,Williamson,48469,Victoria,TX,Rural Texas,93,4014000,43161.290322580644,74,1943000,26256.756756756757,19,2071000
2019,county,48453,Travis,48469,Victoria,TX,Rural Texas,136,5101000,37507.35294117647,60,2289000,38150.0,76,2812000
2019,county,48029,Bexar,48469,Victoria,TX,Rural Texas,219,5888000,26885.844748858446,138,4025000,29166.666666666668,81,1863000
2019,county,48029,Bexar,51810,Virginia Beach city,VA,Hampton Roads,176,5566000,31625.0,115,3985000,34652.17391304348,61,1581000
2019,county,48453,Travis,12127,Volusia,FL,Atlantic Coast,52,2255000,43365.38461538462,48,1665000,34687.5,4,590000
2019,county,48029,Bexar,12127,Volusia,FL,Atlantic Coast,44,1050000,23863.636363636364,42,1417000,33738.09523809524,2,-367000
2019,county,48491,Williamson,37183,Wake,NC,Raleigh,106,4198000,39603.77358490566,120,4847000,40391.666666666664,-14,-649000
2019,county,48453,Travis,37183,Wake,NC,Raleigh,242,15172000,62694.21487603306,195,13098000,67169.23076923077,47,2074000
2019,county,48029,Bexar,37183,Wake,NC,Raleigh,130,4709000,36223.07692307692,112,3953000,35294.642857142855,18,756000
2019,county,48029,Bexar,48471,Walker,TX,Rural Texas,47,813000,17297.872340425532,29,928000,32000.0,18,-115000
2019,county,48029,Bexar,38101,Ward,ND,Rural North Dakota,79,1703000,21556.962025316454,56,1153000,20589.285714285714,23,550000
2019,county,48453,Travis,41067,Washington,OR,Portland,186,13906000,74763.44086021505,148,9103000,61506.75675675676,38,4803000
2019,county,48453,Travis,48477,Washington,TX,Rural Texas,51,2411000,47274.509803921566,38,1391000,36605.26315789474,13,1020000
2019,county,48029,Bexar,41067,Washington,OR,Portland,76,2219000,29197.36842105263,63,1846000,29301.5873015873,13,373000
2019,county,48453,Travis,32031,Washoe,NV,Rural Nevada,85,6398000,75270.58823529411,49,2494000,50897.95918367347,36,3904000
2019,county,48029,Bexar,32031,Washoe,NV,Rural Nevada,86,2225000,25872.093023255813,56,1496000,26714.285714285714,30,729000
2019,county,48453,Travis,26161,Washtenaw,MI,Rural Michigan,95,8254000,86884.21052631579,46,2067000,44934.782608695656,49,6187000
2019,county,48029,Bexar,26161,Washtenaw,MI,Rural Michigan,30,871000,29033.333333333332,31,1507000,48612.903225806454,-1,-636000
2019,county,48453,Travis,26163,Wayne,MI,Detroit,151,4157000,27529.80132450331,110,1936000,17600.0,41,2221000
2019,county,48029,Bexar,26163,Wayne,MI,Detroit,112,2839000,25348.214285714286,86,1792000,20837.20930232558,26,1047000
2019,county,48491,Williamson,48479,Webb,TX,Rural Texas,71,1971000,27760.563380281692,38,1007000,26500.0,33,964000
2019,county,48453,Travis,48479,Webb,TX,Rural Texas,239,7483000,31309.623430962343,116,2567000,22129.310344827587,123,4916000
2019,county,48029,Bexar,48479,Webb,TX,Rural Texas,1338,28749000,21486.547085201793,676,10770000,15931.952662721893,662,17979000
2019,county,48029,Bexar,08123,Weld,CO,Rural Colorado,56,1399000,24982.14285714286,39,1440000,36923.07692307692,17,-41000
2019,county,48453,Travis,36119,Westchester,NY,New York,71,4651000,65507.042253521126,48,5413000,112770.83333333333,23,-762000
2019,county,48029,Bexar,36119,Westchester,NY,New York,48,1606000,33458.333333333336,34,1470000,43235.294117647056,14,136000
2019,county,48453,Travis,48485,Wichita,TX,Rural Texas,71,2201000,31000.0,48,2088000,43500.0,23,113000
2019,county,48029,Bexar,48485,Wichita,TX,Rural Texas,137,4136000,30189.781021897812,104,2657000,25548.076923076922,33,1479000
2019,county,48453,Travis,48491,Williamson,TX,Austin,13631,503426000,36932.43342381337,19847,746532000,37614.34977578475,-6216,-243106000
2019,county,48209,Hays,48491,Williamson,TX,Austin,669,24522000,36654.708520179374,822,24551000,29867.396593673966,-153,-29000
2019,county,48091,Comal,48491,Williamson,TX,Austin,217,7817000,36023.041474654376,142,6274000,44183.09859154929,75,1543000
2019,county,48029,Bexar,48491,Williamson,TX,Austin,700,21620000,30885.714285714286,1022,34792000,34043.052837573385,-322,-13172000
2019,county,48453,Travis,48493,Wilson,TX,Rural Texas,30,1002000,33400.0,34,1051000,30911.764705882353,-4,-49000
2019,county,48091,Comal,48493,Wilson,TX,Rural Texas,115,3318000,28852.17391304348,65,2585000,39769.230769230766,50,733000
2019,county,48029,Bexar,48493,Wilson,TX,Rural Texas,1002,30848000,30786.42714570858,1435,44200000,30801.393728222996,-433,-13352000
2019,county,48453,Travis,25027,Worcester,MA,Rural Massachusetts,81,3478000,42938.27160493827,43,1793000,41697.67441860465,38,1685000
2019,county,48029,Bexar,51199,York,VA,Hampton Roads,135,2935000,21740.74074074074,86,2231000,25941.86046511628,49,704000
2019,county,48029,Bexar,04027,Yuma,AZ,Rural Arizona,44,658000,14954.545454545454,34,1023000,30088.235294117647,10,-365000
2019,county,48029,Bexar,48507,Zavala,TX,Rural Texas,61,1121000,18377.049180327867,48,936000,19500.0,13,185000
2019,total,48491,Williamson,96000,,,,51444,2021293000,39291.132104813,34524,1245795000,36084.89746263469,16920,775498000
2019,total,48453,Travis,96000,,,,79744,4481965000,56204.41663322633,74681,3372251000,45155.40766727816,5063,1109714000
2019,total,48209,Hays,96000,,,,19034,729190000,38309.86655458653,14278,545691000,38219.00826446281,4756,183499000
2019,total,48091,Comal,96000,,,,16680,690143000,41375.479616306955,9873,374490000,37930.72014585233,6807,315653000
2019,total,48029,Bexar,96000,,,,80376,2459648000,30601.77167313626,74162,2427058000,32726.43671961382,6214,32590000
2020,county,48491,Williamson,16001,Ada,ID,Rural Idaho,49,1485000,30306.122448979593,39,1193000,30589.74358974359,10,292000
2020,county,48453,Travis,16001,Ada,ID,Rural Idaho,69,2476000,35884.057971014496,134,7754000,57865.67164179104,-65,-5278000
2020,county,48029,Bexar,16001,Ada,ID,Rural Idaho,54,1562000,28925.925925925927,76,3544000,46631.57894736842,-22,-1982000
2020,county,48453,Travis,08001,Adams,CO,Denver,57,3591000,63000.0,74,2407000,32527.027027027027,-17,1184000
2020,county,48029,Bexar,08001,Adams,CO,Denver,79,1620000,20506.32911392405,96,2370000,24687.5,-17,-750000
2020,county,48453,Travis,12001,Alachua,FL,Rural Florida,55,2251000,40927.27272727273,48,1757000,36604.166666666664,7,494000
2020,county,48491,Williamson,06001,Alameda,CA,Bay Area,436,29168000,66899.08256880734,46,4496000,97739.13043478261,390,24672000
2020,county,48453,Travis,06001,Alameda,CA,Bay Area,706,57629000,81627.47875354107,236,16628000,70457.62711864407,470,41001000
2020,county,48029,Bexar,06001,Alameda,CA,Bay Area,175,7218000,41245.71428571428,88,2918000,33159.09090909091,87,4300000
2020,county,48453,Travis,51510,Alexandria city,VA,D.C.,62,6384000,102967.74193548386,56,3832000,68428.57142857143,6,2552000
2020,county,48029,Bexar,51510,Alexandria city,VA,D.C.,100,5383000,53830.0,80,3180000,39750.0,20,2203000
2020,county,48453,Travis,42003,Allegheny,PA,Pittsburgh,168,14945000,88958.33333333333,94,4498000,47851.063829787236,74,10447000
2020,county,48029,Bexar,42003,Allegheny,PA,Pittsburgh,95,3226000,33957.89473684211,72,3021000,41958.333333333336,23,205000
2020,county,48453,Travis,02020,Anchorage Borough,AK,Rural Alaska,74,2536000,34270.27027027027,28,1216000,43428.57142857143,46,1320000
2020,county,48029,Bexar,02020,Anchorage Borough,AK,Rural Alaska,226,6589000,29154.867256637168,200,5779000,28895.0,26,810000
2020,county,48453,Travis,24003,Anne Arundel,MD,Baltimore,65,2483000,38200.0,37,1354000,36594.59459459459,28,1129000
2020,county,48029,Bexar,24003,Anne Arundel,MD,Baltimore,353,13334000,37773.371104815866,272,6562000,24125.0,81,6772000
2020,county,48029,Bexar,48007,Aransas,TX,Rural Texas,79,2482000,31417.721518987342,144,5208000,36166.666666666664,-65,-2726000
2020,county,48491,Williamson,08005,Arapahoe,CO,Denver,82,3378000,41195.12195121951,85,2840000,33411.76470588235,-3,538000
2020,county,48453,Travis,08005,Arapahoe,CO,Denver,133,8027000,60353.38345864662,152,7538000,49592.10526315789,-19,489000
2020,county,48029,Bexar,08005,Arapahoe,CO,Denver,251,8376000,33370.517928286856,282,7164000,25404.255319148935,-31,1212000
2020,county,48453,Travis,51013,Arlington,VA,D.C.,132,11317000,85734.84848484848,83,6635000,79939.75903614458,49,4682000
2020,county,48029,Bexar,51013,Arlington,VA,D.C.,69,4957000,71840.57971014493,75,4031000,53746.666666666664,-6,926000
2020,county,48029,Bexar,48013,Atascosa,TX,Rural Texas,1556,-86991000,-55906.81233933162,1924,37847000,19670.99792099792,-368,-124838000
2020,county,48029,Bexar,24005,Baltimore,MD,Baltimore,77,2702000,35090.90909090909,30,1305000,43500.0,47,1397000
2020,county,48453,Travis,24510,Baltimore city,MD,Baltimore,95,4896000,51536.84210526316,66,3642000,55181.818181818184,29,1254000
2020,county,48029,Bexar,48019,Bandera,TX,Rural Texas,366,8013000,21893.44262295082,620,19127000,30850.0,-254,-11114000
2020,county,48491,Williamson,48021,Bastrop,TX,Austin,495,12035000,24313.131313131315,589,18239000,30966.044142614603,-94,-6204000
2020,county,48453,Travis,48021,Bastrop,TX,Austin,1667,33875000,20320.935812837433,4197,103702000,24708.60138193948,-2530,-69827000
2020,county,48209,Hays,48021,Bastrop,TX,Austin,255,6182000,24243.13725490196,390,11378000,29174.358974358973,-135,-5196000
2020,county,48091,Comal,48021,Bastrop,TX,Austin,41,1128000,27512.19512195122,50,1947000,38940.0,-9,-819000
2020,county,48029,Bexar,48021,Bastrop,TX,Austin,73,1773000,24287.671232876713,167,5326000,31892.215568862277,-94,-3553000
2020,county,48029,Bexar,12005,Bay,FL,FL Panhandle,60,1662000,27700.0,79,2375000,30063.291139240508,-19,-713000
2020,county,48029,Bexar,48025,Bee,TX,Rural Texas,146,3685000,25239.72602739726,108,2382000,22055.555555555555,38,1303000
2020,county,48491,Williamson,48027,Bell,TX,Rural Texas,1955,48717000,24919.18158567775,2063,54297000,26319.4377120698,-108,-5580000
2020,county,48453,Travis,48027,Bell,TX,Rural Texas,1212,29537000,24370.46204620462,1654,35950000,21735.187424425636,-442,-6413000
2020,county,48209,Hays,48027,Bell,TX,Rural Texas,153,3391000,22163.398692810457,154,4006000,26012.987012987014,-1,-615000
2020,county,48091,Comal,48027,Bell,TX,Rural Texas,108,2911000,26953.703703703704,61,1790000,29344.262295081968,47,1121000
2020,county,48029,Bexar,48027,Bell,TX,Rural Texas,938,20728000,22098.081023454157,727,15284000,21023.383768913343,211,5444000
2020,county,48491,Williamson,05007,Benton,AR,Rural Arkansas,55,2712000,49309.09090909091,38,2455000,64605.26315789474,17,257000
2020,county,48453,Travis,05007,Benton,AR,Rural Arkansas,57,6201000,108789.47368421052,112,6131000,54741.07142857143,-55,70000
2020,county,48029,Bexar,05007,Benton,AR,Rural Arkansas,68,3320000,48823.529411764706,55,2578000,46872.72727272727,13,742000
2020,county,48453,Travis,34003,Bergen,NJ,New York,101,12598000,124732.67326732674,55,2977000,54127.27272727273,46,9621000
2020,county,48029,Bexar,45015,Berkeley,SC,Charleston,97,2567000,26463.917525773195,48,1555000,32395.833333333332,49,1012000
2020,county,48491,Williamson,35001,Bernalillo,NM,Albuquerque,91,3329000,36582.41758241758,59,2386000,40440.67796610169,32,943000
2020,county,48453,Travis,35001,Bernalillo,NM,Albuquerque,128,6163000,48148.4375,167,11525000,69011.97604790419,-39,-5362000
2020,county,48029,Bexar,35001,Bernalillo,NM,Albuquerque,235,7127000,30327.659574468085,200,6076000,30380.0,35,1051000
2020,county,48491,Williamson,48029,Bexar,TX,San Antonio,1117,38279000,34269.471799462845,884,28588000,32339.366515837104,233,9691000
2020,county,48453,Travis,48029,Bexar,TX,San Antonio,2689,125461000,46657.12160654518,2549,211894000,83128.28560219693,140,-86433000
2020,county,48209,Hays,48029,Bexar,TX,San Antonio,843,29239000,34684.460260972715,811,21794000,26872.99630086313,32,7445000
2020,county,48091,Comal,48029,Bexar,TX,San Antonio,5083,206309000,40588.038559905566,2308,89828000,38920.27729636049,2775,116481000
2020,county,48453,Travis,48031,Blanco,TX,Rural Texas,54,1524000,28222.222222222223,123,23221000,188788.61788617886,-69,-21697000
2020,county,48209,Hays,48031,Blanco,TX,Rural Texas,64,2589000,40453.125,141,4760000,33758.86524822695,-77,-2171000
2020,county,48091,Comal,48031,Blanco,TX,Rural Texas,89,2715000,30505.61797752809,139,7346000,52848.92086330935,-50,-4631000
2020,county,48029,Bexar,48031,Blanco,TX,Rural Texas,36,2569000,71361.11111111111,96,2034000,21187.5,-60,535000
2020,county,48029,Bexar,22015,Bossier Parish,LA,Rural Louisiana,157,4197000,26732.48407643312,55,1922000,34945.454545454544,102,2275000
2020,county,48453,Travis,08013,Boulder,CO,Denver,89,6029000,67741.57303370787,179,13248000,74011.17318435754,-90,-7219000
2020,county,48029,Bexar,08013,Boulder,CO,Denver,36,1389000,38583.333333333336,44,2502000,56863.63636363636,-8,-1113000
2020,county,48491,Williamson,48039,Brazoria,TX,Houston,115,4706000,40921.739130434784,80,2351000,29387.5,35,2355000
2020,county,48453,Travis,48039,Brazoria,TX,Houston,183,8327000,45502.73224043716,178,5630000,31629.213483146068,5,2697000
2020,county,48209,Hays,48039,Brazoria,TX,Houston,62,3329000,53693.54838709677,45,1265000,28111.11111111111,17,2064000
2020,county,48029,Bexar,48039,Brazoria,TX,Houston,259,11532000,44525.096525096524,251,7008000,27920.3187250996,8,4524000
2020,county,48491,Williamson,48041,Brazos,TX,Rural Texas,263,7929000,30148.28897338403,191,7100000,37172.77486910995,72,829000
2020,county,48453,Travis,48041,Brazos,TX,Rural Texas,482,16946000,35157.67634854772,406,13280000,32709.35960591133,76,3666000
2020,county,48209,Hays,48041,Brazos,TX,Rural Texas,59,1685000,28559.322033898305,61,2736000,44852.45901639344,-2,-1051000
2020,county,48091,Comal,48041,Brazos,TX,Rural Texas,73,3726000,51041.09589041096,51,2032000,39843.13725490196,22,1694000
2020,county,48029,Bexar,48041,Brazos,TX,Rural Texas,382,9746000,25513.0890052356,332,8580000,25843.373493975905,50,1166000
2020,county,48453,Travis,12009,Brevard,FL,Atlantic Coast,44,1638000,37227.27272727273,61,2512000,41180.32786885246,-17,-874000
2020,county,48029,Bexar,12009,Brevard,FL,Atlantic Coast,115,3241000,28182.608695652172,112,4153000,37080.357142857145,3,-912000
2020,county,48491,Williamson,12011,Broward,FL,Miami,128,3234000,25265.625,46,2860000,62173.913043478264,82,374000
2020,county,48453,Travis,12011,Broward,FL,Miami,291,13049000,44841.92439862543,129,7462000,57844.96124031008,162,5587000
2020,county,48029,Bexar,12011,Broward,FL,Miami,249,7505000,30140.562248995982,127,5204000,40976.37795275591,122,2301000
2020,county,48491,Williamson,48049,Brown,TX,Rural Texas,48,1144000,23833.333333333332,73,1583000,21684.931506849316,-25,-439000
2020,county,48453,Travis,48049,Brown,TX,Rural Texas,39,800000,20512.82051282051,42,778000,18523.809523809523,-3,22000
2020,county,48029,Bexar,34005,Burlington,NJ,Philadelphia,140,3649000,26064.285714285714,77,2338000,30363.636363636364,63,1311000
2020,county,48491,Williamson,48053,Burnet,TX,Rural Texas,395,10205000,25835.443037974685,910,36364000,39960.43956043956,-515,-26159000
2020,county,48453,Travis,48053,Burnet,TX,Rural Texas,321,16558000,51582.554517133955,914,54650000,59792.12253829322,-593,-38092000
2020,county,48209,Hays,48053,Burnet,TX,Rural Texas,65,3233000,49738.46153846154,101,4042000,40019.80198019802,-36,-809000
2020,county,48029,Bexar,48053,Burnet,TX,Rural Texas,87,2598000,29862.068965517243,138,6865000,49746.3768115942,-51,-4267000
2020,county,48029,Bexar,22017,Caddo Parish,LA,Rural Louisiana,84,1670000,19880.95238095238,63,1464000,23238.095238095237,21,206000
2020,county,48029,Bexar,22019,Calcasieu Parish,LA,Rural Louisiana,100,2598000,25980.0,68,2257000,33191.17647058824,32,341000
2020,county,48491,Williamson,48055,Caldwell,TX,Rural Texas,94,2567000,27308.510638297874,119,2818000,23680.67226890756,-25,-251000
2020,county,48453,Travis,48055,Caldwell,TX,Rural Texas,422,11050000,26184.83412322275,1003,21197000,21133.599202392823,-581,-10147000
2020,county,48209,Hays,48055,Caldwell,TX,Rural Texas,778,16468000,21167.095115681233,776,16004000,20623.711340206184,2,464000
2020,county,48091,Comal,48055,Caldwell,TX,Rural Texas,101,2441000,24168.31683168317,40,1803000,45075.0,61,638000
2020,county,48029,Bexar,48055,Caldwell,TX,Rural Texas,83,1499000,18060.24096385542,136,2566000,18867.647058823528,-53,-1067000
2020,county,48491,Williamson,48061,Cameron,TX,Rural Texas,125,4405000,35240.0,105,3173000,30219.04761904762,20,1232000
2020,county,48453,Travis,48061,Cameron,TX,Rural Texas,352,9941000,28241.477272727272,357,11544000,32336.134453781513,-5,-1603000
2020,county,48209,Hays,48061,Cameron,TX,Rural Texas,96,3111000,32406.25,63,1286000,20412.698412698413,33,1825000
2020,county,48029,Bexar,48061,Cameron,TX,Rural Texas,1058,23308000,22030.24574669187,629,14199000,22573.926868044517,429,9109000
2020,county,48029,Bexar,30013,Cascade,MT,Rural Montana,77,1862000,24181.81818181818,98,2224000,22693.877551020407,-21,-362000
2020,county,48453,Travis,17019,Champaign,IL,Rural Illinois,52,2673000,51403.846153846156,41,1861000,45390.243902439026,11,812000
2020,county,48453,Travis,45019,Charleston,SC,Charleston,81,3890000,48024.69135802469,59,3408000,57762.71186440678,22,482000
2020,county,48029,Bexar,45019,Charleston,SC,Charleston,106,3454000,32584.905660377357,82,3066000,37390.243902439026,24,388000
2020,county,48453,Travis,13051,Chatham,GA,Savannah,30,1675000,55833.333333333336,35,1163000,33228.57142857143,-5,512000
2020,county,48029,Bexar,13051,Chatham,GA,Savannah,76,1670000,21973.684210526317,40,1392000,34800.0,36,278000
2020,county,48029,Bexar,51550,Chesapeake city,VA,Hampton Roads,82,1821000,22207.317073170732,53,1519000,28660.377358490565,29,302000
2020,county,48453,Travis,42029,Chester,PA,Philadelphia,70,10640000,152000.0,49,2329000,47530.61224489796,21,8311000
2020,county,48029,Bexar,51041,Chesterfield,VA,Richmond,54,1840000,34074.07407407407,71,1989000,28014.084507042255,-17,-149000
2020,county,48029,Bexar,21047,Christian,KY,Rural Kentucky,55,923000,16781.81818181818,55,791000,14381.818181818182,0,132000
2020,county,48453,Travis,41005,Clackamas,OR,Portland,51,3659000,71745.09803921569,43,3233000,75186.04651162791,8,426000
2020,county,48029,Bexar,41005,Clackamas,OR,Portland,42,1270000,30238.095238095237,47,2156000,45872.34042553192,-5,-886000
2020,county,48491,Williamson,32003,Clark,NV,Las Vegas,313,10815000,34552.71565495207,130,4730000,36384.61538461538,183,6085000
2020,county,48453,Travis,32003,Clark,NV,Las Vegas,341,27724000,81302.05278592375,234,11258000,48111.11111111111,107,16466000
2020,county,48453,Travis,53011,Clark,WA,Portland,86,5815000,67616.27906976744,65,3951000,60784.61538461538,21,1864000
2020,county,48029,Bexar,32003,Clark,NV,Las Vegas,706,20471000,28995.7507082153,775,20836000,26885.16129032258,-69,-365000
2020,county,48029,Bexar,53011,Clark,WA,Portland,82,1900000,23170.731707317074,77,2613000,33935.06493506493,5,-713000
2020,county,48029,Bexar,29047,Clay,MO,Kansas City,56,1756000,31357.14285714286,60,1526000,25433.333333333332,-4,230000
2020,county,48453,Travis,40027,Cleveland,OK,Oklahoma City,52,2005000,38557.692307692305,50,2111000,42220.0,2,-106000
2020,county,48029,Bexar,40027,Cleveland,OK,Oklahoma City,86,2714000,31558.13953488372,69,2702000,39159.42028985507,17,12000
2020,county,48453,Travis,13067,Cobb,GA,Atlanta,105,4346000,41390.47619047619,95,3894000,40989.47368421053,10,452000
2020,county,48029,Bexar,13067,Cobb,GA,Atlanta,93,9208000,99010.75268817204,86,2787000,32406.976744186046,7,6421000
2020,county,48029,Bexar,04003,Cochise,AZ,Rural Arizona,80,2013000,25162.5,76,1932000,25421.052631578947,4,81000
2020,county,48029,Bexar,12021,Collier,FL,S.W. Florida,44,832000,18909.090909090908,51,1498000,29372.549019607843,-7,-666000
2020,county,48491,Williamson,48085,Collin,TX,Dallas-Fort Worth,427,21799000,51051.52224824356,489,19209000,39282.20858895705,-62,2590000
2020,county,48453,Travis,48085,Collin,TX,Dallas-Fort Worth,874,50740000,58054.91990846682,889,46232000,52004.4994375703,-15,4508000
2020,county,48209,Hays,48085,Collin,TX,Dallas-Fort Worth,128,6266000,48953.125,113,4093000,36221.238938053095,15,2173000
2020,county,48091,Comal,48085,Collin,TX,Dallas-Fort Worth,86,4305000,50058.13953488372,62,4727000,76241.93548387097,24,-422000
2020,county,48029,Bexar,48085,Collin,TX,Dallas-Fort Worth,491,18247000,37162.93279022403,790,33274000,42118.987341772154,-299,-15027000
2020,county,48029,Bexar,13073,Columbia,GA,Augusta,116,3636000,31344.827586206895,120,2641000,22008.333333333332,-4,995000
2020,county,48491,Williamson,48091,Comal,TX,San Antonio,206,7014000,34048.54368932039,254,10920000,42992.12598425197,-48,-3906000
2020,county,48453,Travis,48091,Comal,TX,San Antonio,375,17138000,45701.333333333336,773,40167000,51962.48382923674,-398,-23029000
2020,county,48209,Hays,48091,Comal,TX,San Antonio,622,21041000,33827.97427652733,1122,37857000,33740.641711229946,-500,-16816000
2020,county,48029,Bexar,48091,Comal,TX,San Antonio,2308,89828000,38920.27729636049,5083,206309000,40588.038559905566,-2775,-116481000
2020,county,48029,Bexar,40031,Comanche,OK,Rural Oklahoma,99,2217000,22393.939393939392,87,1420000,16321.83908045977,12,797000
2020,county,48453,Travis,06013,Contra Costa,CA,Bay Area,370,88975000,240472.97297297296,98,6005000,61275.510204081635,272,82970000
2020,county,48029,Bexar,06013,Contra Costa,CA,Bay Area,129,6082000,47147.28682170543,43,1346000,31302.325581395347,86,4736000
2020,county,48491,Williamson,17031,Cook,IL,Chicago,341,18133000,53175.953079178886,103,4242000,41184.46601941747,238,13891000
2020,county,48453,Travis,17031,Cook,IL,Chicago,1189,190242000,160001.68208578636,500,28948000,57896.0,689,161294000
2020,county,48029,Bexar,17031,Cook,IL,Chicago,629,26734000,42502.384737678854,335,13686000,40853.73134328358,294,13048000
2020,county,48491,Williamson,48099,Coryell,TX,Rural Texas,206,4625000,22451.456310679612,153,3212000,20993.46405228758,53,1413000
2020,county,48453,Travis,48099,Coryell,TX,Rural Texas,160,3176000,19850.0,158,3482000,22037.974683544304,2,-306000
2020,county,48029,Bexar,48099,Coryell,TX,Rural Texas,162,2948000,18197.53086419753,218,2916000,13376.146788990825,-56,32000
2020,county,48453,Travis,23005,Cumberland,ME,Portland,40,1755000,43875.0,50,3781000,75620.0,-10,-2026000
2020,county,48453,Travis,37051,Cumberland,NC,Rural North Carolina,56,1560000,27857.14285714286,46,922000,20043.478260869564,10,638000
2020,county,48029,Bexar,37051,Cumberland,NC,Rural North Carolina,312,8234000,26391.02564102564,224,6006000,26812.5,88,2228000
2020,county,48029,Bexar,35009,Curry,NM,Rural New Mexico,80,2090000,26125.0,111,2792000,25153.153153153155,-31,-702000
2020,county,48453,Travis,39035,Cuyahoga,OH,Cleveland,130,6787000,52207.692307692305,84,6587000,78416.66666666667,46,200000
2020,county,48029,Bexar,39035,Cuyahoga,OH,Cleveland,99,4455000,45000.0,43,1506000,35023.25581395349,56,2949000
2020,county,48491,Williamson,48113,Dallas,TX,Dallas-Fort Worth,714,32188000,45081.2324929972,447,18662000,41749.44071588367,267,13526000
2020,county,48453,Travis,48113,Dallas,TX,Dallas-Fort Worth,2251,169016000,75084.85117725456,1652,84038000,50870.460048426154,599,84978000
2020,county,48209,Hays,48113,Dallas,TX,Dallas-Fort Worth,260,12960000,49846.153846153844,190,5372000,28273.684210526317,70,7588000
2020,county,48091,Comal,48113,Dallas,TX,Dallas-Fort Worth,118,6314000,53508.47457627119,81,3869000,47765.432098765436,37,2445000
2020,county,48029,Bexar,48113,Dallas,TX,Dallas-Fort Worth,1224,81928000,66934.64052287582,1292,58556000,45321.98142414861,-68,23372000
2020,county,48453,Travis,55025,Dane,WI,Madison,128,7275000,56835.9375,95,4678000,49242.10526315789,33,2597000
2020,county,48029,Bexar,55025,Dane,WI,Madison,100,3023000,30230.0,51,980000,19215.686274509804,49,2043000
2020,county,48491,Williamson,47037,Davidson,TN,Nashville,52,2333000,44865.38461538462,50,2089000,41780.0,2,244000
2020,county,48453,Travis,47037,Davidson,TN,Nashville,186,8829000,47467.74193548387,182,10673000,58642.857142857145,4,-1844000
2020,county,48029,Bexar,47037,Davidson,TN,Nashville,135,4827000,35755.555555555555,125,4661000,37288.0,10,166000
2020,county,48029,Bexar,49011,Davis,UT,Rural Utah,137,3415000,24927.007299270073,84,2273000,27059.52380952381,53,1142000
2020,county,48453,Travis,13089,DeKalb,GA,Atlanta,112,6344000,56642.857142857145,101,4758000,47108.91089108911,11,1586000
2020,county,48029,Bexar,13089,DeKalb,GA,Atlanta,106,3847000,36292.45283018868,72,2687000,37319.444444444445,34,1160000
2020,county,48491,Williamson,48121,Denton,TX,Dallas-Fort Worth,427,17299000,40512.88056206089,367,16238000,44245.23160762943,60,1061000
2020,county,48453,Travis,48121,Denton,TX,Dallas-Fort Worth,670,50912000,75988.05970149254,575,27083000,47100.86956521739,95,23829000
2020,county,48209,Hays,48121,Denton,TX,Dallas-Fort Worth,129,4668000,36186.04651162791,113,3221000,28504.424778761062,16,1447000
2020,county,48091,Comal,48121,Denton,TX,Dallas-Fort Worth,62,3711000,59854.83870967742,82,4018000,49000.0,-20,-307000
2020,county,48029,Bexar,48121,Denton,TX,Dallas-Fort Worth,569,21903000,38493.84885764499,732,29019000,39643.44262295082,-163,-7116000
2020,county,48491,Williamson,08031,Denver,CO,Denver,62,2656000,42838.709677419356,66,3616000,54787.878787878784,-4,-960000
2020,county,48453,Travis,08031,Denver,CO,Denver,320,23758000,74243.75,420,28658000,68233.33333333333,-100,-4900000
2020,county,48029,Bexar,08031,Denver,CO,Denver,173,8496000,49109.826589595374,232,10991000,47375.0,-59,-2495000
2020,county,48029,Bexar,48127,Dimmit,TX,Rural Texas,102,1323000,12970.588235294117,52,798000,15346.153846153846,50,525000
2020,county,48453,Travis,11001,District of Columbia,DC,D.C.,299,37313000,124792.64214046823,154,10135000,65811.68831168831,145,27178000
2020,county,48029,Bexar,11001,District of Columbia,DC,D.C.,133,6384000,48000.0,103,6556000,63650.48543689321,30,-172000
2020,county,48453,Travis,35013,Dona Ana,NM,Rural New Mexico,42,1876000,44666.666666666664,52,1565000,30096.153846153848,-10,311000
2020,county,48029,Bexar,35013,Dona Ana,NM,Rural New Mexico,83,3347000,40325.301204819276,83,3552000,42795.180722891564,0,-205000
2020,county,48491,Williamson,08035,Douglas,CO,Denver,117,5954000,50888.88888888889,84,3063000,36464.28571428572,33,2891000
2020,county,48453,Travis,08035,Douglas,CO,Denver,132,10904000,82606.06060606061,150,10943000,72953.33333333333,-18,-39000
2020,county,48453,Travis,31055,Douglas,NE,Omaha,86,5901000,68616.27906976744,45,2099000,46644.444444444445,41,3802000
2020,county,48029,Bexar,31055,Douglas,NE,Omaha,109,4802000,44055.04587155963,61,2419000,39655.737704918036,48,2383000
2020,county,48029,Bexar,08035,Douglas,CO,Denver,107,5580000,52149.53271028037,120,4283000,35691.666666666664,-13,1297000
2020,county,48453,Travis,17043,DuPage,IL,Chicago,176,15406000,87534.09090909091,61,4000000,65573.77049180328,115,11406000
2020,county,48029,Bexar,17043,DuPage,IL,Chicago,167,5587000,33455.08982035928,80,1804000,22550.0,87,3783000
2020,county,48453,Travis,37063,Durham,NC,Raleigh,86,4778000,55558.13953488372,76,5657000,74434.21052631579,10,-879000
2020,county,48029,Bexar,37063,Durham,NC,Raleigh,35,1383000,39514.28571428572,30,1517000,50566.666666666664,5,-134000
2020,county,48453,Travis,12031,Duval,FL,Jacksonville,86,4337000,50430.232558139534,103,4506000,43747.57281553398,-17,-169000
2020,county,48029,Bexar,12031,Duval,FL,Jacksonville,219,7407000,33821.91780821918,154,4474000,29051.948051948053,65,2933000
2020,county,48453,Travis,22033,East Baton Rouge Parish,LA,Rural Louisiana,120,4335000,36125.0,49,2388000,48734.69387755102,71,1947000
2020,county,48029,Bexar,22033,East Baton Rouge Parish,LA,Rural Louisiana,83,2100000,25301.204819277107,75,1759000,23453.333333333332,8,341000
2020,county,48453,Travis,48135,Ector,TX,Rural Texas,119,4104000,34487.39495798319,64,1360000,21250.0,55,2744000
2020,county,48029,Bexar,48135,Ector,TX,Rural Texas,313,8702000,27801.91693290735,167,3340000,20000.0,146,5362000
2020,county,48491,Williamson,48141,El Paso,TX,El Paso,344,9447000,27462.20930232558,139,3174000,22834.53237410072,205,6273000
2020,county,48491,Williamson,08041,El Paso,CO,Colorado Springs,174,6680000,38390.80459770115,156,5406000,34653.846153846156,18,1274000
2020,county,48453,Travis,48141,El Paso,TX,El Paso,481,16200000,33679.83367983368,373,11073000,29686.32707774799,108,5127000
2020,county,48453,Travis,08041,El Paso,CO,Colorado Springs,188,11384000,60553.1914893617,173,7862000,45445.08670520231,15,3522000
2020,county,48209,Hays,48141,El Paso,TX,El Paso,74,1962000,26513.513513513513,51,1660000,32549.019607843136,23,302000
2020,county,48209,Hays,08041,El Paso,CO,Colorado Springs,46,2010000,43695.65217391304,39,2051000,52589.743589743586,7,-41000
2020,county,48029,Bexar,48141,El Paso,TX,El Paso,1637,36043000,22017.715332926084,1049,25713000,24511.916110581507,588,10330000
2020,county,48029,Bexar,08041,El Paso,CO,Colorado Springs,772,17476000,22637.305699481865,790,22693000,28725.316455696204,-18,-5217000
2020,county,48491,Williamson,48139,Ellis,TX,Dallas-Fort Worth,57,1866000,32736.842105263157,71,2418000,34056.33802816901,-14,-552000
2020,county,48453,Travis,48139,Ellis,TX,Dallas-Fort Worth,82,2401000,29280.48780487805,75,2659000,35453.333333333336,7,-258000
2020,county,48029,Bexar,48139,Ellis,TX,Dallas-Fort Worth,60,1750000,29166.666666666668,92,4316000,46913.04347826087,-32,-2566000
2020,county,48453,Travis,36029,Erie,NY,Buffalo,47,2027000,43127.65957446808,58,2051000,35362.06896551724,-11,-24000
2020,county,48029,Bexar,36029,Erie,NY,Buffalo,73,1917000,26260.27397260274,42,1097000,26119.04761904762,31,820000
2020,county,48029,Bexar,12033,Escambia,FL,FL Panhandle,138,3240000,23478.260869565216,141,3261000,23127.659574468085,-3,-21000
2020,county,48453,Travis,25009,Essex,MA,Boston,68,3602000,52970.58823529412,32,2627000,82093.75,36,975000
2020,county,48453,Travis,34013,Essex,NJ,New York,57,4044000,70947.36842105263,38,2326000,61210.52631578947,19,1718000
2020,county,48029,Bexar,02090,Fairbanks North Star Borough,AK,Rural Alaska,158,4248000,26886.07594936709,101,2267000,22445.544554455446,57,1981000
2020,county,48491,Williamson,51059,Fairfax,VA,D.C.,167,8564000,51281.4371257485,71,2833000,39901.40845070423,96,5731000
2020,county,48453,Travis,51059,Fairfax,VA,D.C.,278,19936000,71712.23021582734,160,10409000,65056.25,118,9527000
2020,county,48029,Bexar,51059,Fairfax,VA,D.C.,460,22962000,49917.391304347824,452,15744000,34831.85840707965,8,7218000
2020,county,48453,Travis,09001,Fairfield,CT,New York,197,17006000,86324.8730964467,46,2368000,51478.260869565216,151,14638000
2020,county,48453,Travis,48149,Fayette,TX,Rural Texas,57,2132000,37403.508771929824,89,4690000,52696.629213483146,-32,-2558000
2020,county,48029,Bexar,48149,Fayette,TX,Rural Texas,57,1523000,26719.298245614034,44,967000,21977.272727272728,13,556000
2020,county,48491,Williamson,48157,Fort Bend,TX,Houston,351,18299000,52133.903133903135,272,10324000,37955.882352941175,79,7975000
2020,county,48453,Travis,48157,Fort Bend,TX,Houston,680,38561000,56707.35294117647,546,32842000,60150.18315018315,134,5719000
2020,county,48209,Hays,48157,Fort Bend,TX,Houston,141,8214000,58255.31914893617,91,2941000,32318.68131868132,50,5273000
2020,county,48091,Comal,48157,Fort Bend,TX,Houston,191,14759000,77272.25130890052,67,3786000,56507.46268656717,124,10973000
2020,county,48029,Bexar,48157,Fort Bend,TX,Houston,566,27096000,47872.79151943463,710,27442000,38650.704225352114,-144,-346000
2020,county,48453,Travis,39049,Franklin,OH,Columbus,138,6444000,46695.65217391304,126,5981000,47468.25396825397,12,463000
2020,county,48029,Bexar,39049,Franklin,OH,Columbus,149,5290000,35503.355704697984,141,4108000,29134.751773049644,8,1182000
2020,county,48029,Bexar,24021,Frederick,MD,Rural Maryland,68,3692000,54294.117647058825,57,1628000,28561.40350877193,11,2064000
2020,county,48029,Bexar,06019,Fresno,CA,Fresno,91,1803000,19813.186813186814,79,2179000,27582.278481012658,12,-376000
2020,county,48029,Bexar,48163,Frio,TX,Rural Texas,203,4830000,23793.103448275862,180,6300000,35000.0,23,-1470000
2020,county,48491,Williamson,13121,Fulton,GA,Atlanta,81,3501000,43222.22222222222,61,2438000,39967.2131147541,20,1063000
2020,county,48453,Travis,13121,Fulton,GA,Atlanta,304,19432000,63921.05263157895,240,25773000,107387.5,64,-6341000
2020,county,48029,Bexar,13121,Fulton,GA,Atlanta,128,6917000,54039.0625,140,4852000,34657.142857142855,-12,2065000
2020,county,48491,Williamson,48167,Galveston,TX,Houston,148,6833000,46168.91891891892,126,5339000,42373.01587301587,22,1494000
2020,county,48453,Travis,48167,Galveston,TX,Houston,230,11884000,51669.565217391304,211,9491000,44981.04265402844,19,2393000
2020,county,48209,Hays,48167,Galveston,TX,Houston,83,3766000,45373.49397590361,53,2610000,49245.28301886792,30,1156000
2020,county,48091,Comal,48167,Galveston,TX,Houston,110,6739000,61263.63636363636,59,4634000,78542.37288135593,51,2105000
2020,county,48029,Bexar,48167,Galveston,TX,Houston,230,7358000,31991.304347826088,257,10034000,39042.801556420236,-27,-2676000
2020,county,48029,Bexar,40047,Garfield,OK,Rural Oklahoma,47,1508000,32085.106382978724,56,1379000,24625.0,-9,129000
2020,county,48029,Bexar,20061,Geary,KS,Rural Kansas,80,1580000,19750.0,56,1079000,19267.85714285714,24,501000
2020,county,48453,Travis,48171,Gillespie,TX,Rural Texas,63,3454000,54825.39682539683,140,11241000,80292.85714285714,-77,-7787000
2020,county,48029,Bexar,48171,Gillespie,TX,Rural Texas,106,3208000,30264.150943396227,168,6926000,41226.19047619047,-62,-3718000
2020,county,48029,Bexar,48177,Gonzales,TX,Rural Texas,72,2139000,29708.333333333332,84,1608000,19142.85714285714,-12,531000
2020,county,48453,Travis,48181,Grayson,TX,Rural Texas,39,1312000,33641.02564102564,52,3438000,66115.38461538461,-13,-2126000
2020,county,48029,Bexar,39057,Greene,OH,Rural Ohio,104,4566000,43903.846153846156,98,3314000,33816.32653061225,6,1252000
2020,county,48453,Travis,45045,Greenville,SC,Greenville,54,3215000,59537.03703703704,45,3256000,72355.55555555556,9,-41000
2020,county,48453,Travis,48183,Gregg,TX,Rural Texas,65,4386000,67476.92307692308,35,1383000,39514.28571428572,30,3003000
2020,county,48029,Bexar,48183,Gregg,TX,Rural Texas,56,1906000,34035.71428571428,62,1968000,31741.935483870966,-6,-62000
2020,county,48491,Williamson,48187,Guadalupe,TX,San Antonio,143,4902000,34279.72027972028,153,5246000,34287.5816993464,-10,-344000
2020,county,48453,Travis,48187,Guadalupe,TX,San Antonio,253,8991000,35537.549407114624,345,14720000,42666.666666666664,-92,-5729000
2020,county,48209,Hays,48187,Guadalupe,TX,San Antonio,692,14956000,21612.71676300578,904,22942000,25378.318584070796,-212,-7986000
2020,county,48091,Comal,48187,Guadalupe,TX,San Antonio,2987,104069000,34840.64278540341,2710,80432000,29679.70479704797,277,23637000
2020,county,48029,Bexar,48187,Guadalupe,TX,San Antonio,3747,97462000,26010.675206832133,5313,146623000,27597.026162243554,-1566,-49161000
2020,county,48453,Travis,13135,Gwinnett,GA,Atlanta,94,3188000,33914.89361702128,79,3159000,39987.3417721519,15,29000
2020,county,48029,Bexar,13135,Gwinnett,GA,Atlanta,89,2580000,28988.76404494382,125,2708000,21664.0,-36,-128000
2020,county,48453,Travis,39061,Hamilton,OH,Cincinnati,83,5788000,69734.93975903615,60,3258000,54300.0,23,2530000
2020,county,48453,Travis,18057,Hamilton,IN,Indianapolis,56,3151000,56267.857142857145,61,3606000,59114.75409836065,-5,-455000
2020,county,48029,Bexar,39061,Hamilton,OH,Cincinnati,67,3504000,52298.50746268657,43,1779000,41372.09302325582,24,1725000
2020,county,48029,Bexar,51650,Hampton city,VA,Hampton Roads,71,1812000,25521.12676056338,63,1709000,27126.984126984127,8,103000
2020,county,48029,Bexar,37085,Harnett,NC,Rural North Carolina,142,2097000,14767.605633802817,55,1768000,32145.454545454544,87,329000
2020,county,48491,Williamson,48201,Harris,TX,Houston,1583,83644000,52838.91345546431,932,35671000,38273.60515021459,651,47973000
2020,county,48453,Travis,48201,Harris,TX,Houston,4170,268121000,64297.601918465225,2962,171534000,57911.546252532076,1208,96587000
2020,county,48209,Hays,48201,Harris,TX,Houston,736,38207000,51911.684782608696,483,14659000,30349.896480331263,253,23548000
2020,county,48091,Comal,48201,Harris,TX,Houston,698,45565000,65279.36962750716,247,8983000,36368.42105263158,451,36582000
2020,county,48029,Bexar,48201,Harris,TX,Houston,3244,120318000,37089.39580764488,3199,114452000,35777.43044701469,45,5866000
2020,county,48029,Bexar,28047,Harrison,MS,Gulfport-Biloxi,194,5332000,27484.536082474227,180,4282000,23788.88888888889,14,1050000
2020,county,48453,Travis,09003,Hartford,CT,Hartford,91,5924000,65098.9010989011,46,1819000,39543.47826086957,45,4105000
2020,county,48491,Williamson,48209,Hays,TX,Austin,763,27759000,36381.38925294889,959,33174000,34592.28362877998,-196,-5415000
2020,county,48453,Travis,48209,Hays,TX,Austin,4015,138890000,34592.77708592777,9286,403434000,43445.40167994831,-5271,-264544000
2020,county,48091,Comal,48209,Hays,TX,Austin,1122,37857000,33740.641711229946,622,21041000,33827.97427652733,500,16816000
2020,county,48029,Bexar,48209,Hays,TX,Austin,811,21794000,26872.99630086313,843,29239000,34684.460260972715,-32,-7445000
2020,county,48491,Williamson,27053,Hennepin,MN,Minneapolis,97,5913000,60958.762886597935,42,2829000,67357.14285714286,55,3084000
2020,county,48453,Travis,27053,Hennepin,MN,Minneapolis,270,24156000,89466.66666666667,139,9046000,65079.13669064748,131,15110000
2020,county,48029,Bexar,27053,Hennepin,MN,Minneapolis,96,5496000,57250.0,102,5817000,57029.41176470588,-6,-321000
2020,county,48453,Travis,51087,Henrico,VA,Richmond,42,2030000,48333.333333333336,32,1595000,49843.75,10,435000
2020,county,48491,Williamson,48215,Hidalgo,TX,Rural Texas,216,5972000,27648.14814814815,147,3259000,22170.068027210884,69,2713000
2020,county,48453,Travis,48215,Hidalgo,TX,Rural Texas,570,16244000,28498.245614035088,402,10684000,26577.114427860695,168,5560000
2020,county,48209,Hays,48215,Hidalgo,TX,Rural Texas,117,3722000,31811.965811965812,101,2639000,26128.712871287127,16,1083000
2020,county,48029,Bexar,48215,Hidalgo,TX,Rural Texas,1508,41754000,27688.328912466844,993,24018000,24187.311178247735,515,17736000
2020,county,48491,Williamson,12057,Hillsborough,FL,Tampa,97,3303000,34051.54639175258,100,4172000,41720.0,-3,-869000
2020,county,48453,Travis,12057,Hillsborough,FL,Tampa,209,8905000,42607.65550239234,174,6989000,40166.666666666664,35,1916000
2020,county,48029,Bexar,12057,Hillsborough,FL,Tampa,356,10258000,28814.606741573032,324,11451000,35342.59259259259,32,-1193000
2020,county,48491,Williamson,15003,Honolulu,HI,Rural Hawaii,109,3277000,30064.22018348624,73,2971000,40698.6301369863,36,306000
2020,county,48453,Travis,15003,Honolulu,HI,Rural Hawaii,154,4877000,31668.83116883117,120,5561000,46341.666666666664,34,-684000
2020,county,48029,Bexar,15003,Honolulu,HI,Rural Hawaii,821,20640000,25140.073081607796,588,26905000,45756.80272108843,233,-6265000
2020,county,48029,Bexar,13153,Houston,GA,Rural Georgia,112,3023000,26991.071428571428,130,3289000,25300.0,-18,-266000
2020,county,48453,Travis,24027,Howard,MD,Baltimore,47,2592000,55148.936170212764,53,1779000,33566.03773584906,-6,813000
2020,county,48029,Bexar,24027,Howard,MD,Baltimore,103,4796000,46563.1067961165,71,3562000,50169.01408450704,32,1234000
2020,county,48029,Bexar,48227,Howard,TX,Rural Texas,49,1203000,24551.020408163266,37,1147000,31000.0,12,56000
2020,county,48453,Travis,34017,Hudson,NJ,New York,216,19136000,88592.5925925926,68,5373000,79014.70588235294,148,13763000
2020,county,48453,Travis,26065,Ingham,MI,Rural Michigan,42,1407000,33500.0,28,964000,34428.57142857143,14,443000
2020,county,48453,Travis,29095,Jackson,MO,Kansas City,84,4160000,49523.80952380953,82,2840000,34634.14634146341,2,1320000
2020,county,48029,Bexar,29095,Jackson,MO,Kansas City,106,3253000,30688.67924528302,87,3256000,37425.28735632184,19,-3000
2020,county,48491,Williamson,08059,Jefferson,CO,Denver,63,2450000,38888.88888888889,77,4262000,55350.64935064935,-14,-1812000
2020,county,48453,Travis,48245,Jefferson,TX,Rural Texas,156,5381000,34493.58974358974,93,2615000,28118.279569892475,63,2766000
2020,county,48453,Travis,08059,Jefferson,CO,Denver,113,6820000,60353.982300884956,196,12976000,66204.08163265306,-83,-6156000
2020,county,48453,Travis,21111,Jefferson,KY,Louisville,87,4887000,56172.41379310345,56,2381000,42517.857142857145,31,2506000
2020,county,48453,Travis,01073,Jefferson,AL,Birmingham,67,4495000,67089.55223880598,37,1573000,42513.51351351351,30,2922000
2020,county,48029,Bexar,48245,Jefferson,TX,Rural Texas,117,3910000,33418.80341880342,122,2747000,22516.39344262295,-5,1163000
2020,county,48029,Bexar,08059,Jefferson,CO,Denver,117,3649000,31188.034188034188,129,7456000,57798.4496124031,-12,-3807000
2020,county,48029,Bexar,01073,Jefferson,AL,Birmingham,70,3183000,45471.42857142857,67,2633000,39298.50746268657,3,550000
2020,county,48029,Bexar,36045,Jefferson,NY,Rural New York,110,1493000,13572.727272727272,137,2266000,16540.14598540146,-27,-773000
2020,county,48029,Bexar,21111,Jefferson,KY,Louisville,61,1526000,25016.39344262295,83,2291000,27602.409638554218,-22,-765000
2020,county,48453,Travis,22051,Jefferson Parish,LA,New Orleans,94,2847000,30287.23404255319,47,1438000,30595.744680851065,47,1409000
2020,county,48029,Bexar,22051,Jefferson Parish,LA,New Orleans,86,2066000,24023.25581395349,49,893000,18224.48979591837,37,1173000
2020,county,48029,Bexar,48249,Jim Wells,TX,Rural Texas,268,5507000,20548.507462686568,128,2885000,22539.0625,140,2622000
2020,county,48491,Williamson,48251,Johnson,TX,Dallas-Fort Worth,61,2175000,35655.737704918036,63,1660000,26349.20634920635,-2,515000
2020,county,48453,Travis,20091,Johnson,KS,Kansas City,138,8119000,58833.333333333336,122,6479000,53106.55737704918,16,1640000
2020,county,48453,Travis,48251,Johnson,TX,Dallas-Fort Worth,56,1683000,30053.571428571428,50,2040000,40800.0,6,-357000
2020,county,48029,Bexar,20091,Johnson,KS,Kansas City,97,3200000,32989.69072164949,101,5683000,56267.32673267327,-4,-2483000
2020,county,48029,Bexar,48251,Johnson,TX,Dallas-Fort Worth,56,1470000,26250.0,75,2729000,36386.666666666664,-19,-1259000
2020,county,48029,Bexar,29101,Johnson,MO,Rural Missouri,85,1601000,18835.29411764706,75,1849000,24653.333333333332,10,-248000
2020,county,48029,Bexar,17089,Kane,IL,Chicago,82,2620000,31951.219512195123,43,1009000,23465.116279069767,39,1611000
2020,county,48029,Bexar,48255,Karnes,TX,Rural Texas,68,2886000,42441.17647058824,114,3142000,27561.40350877193,-46,-256000
2020,county,48453,Travis,48257,Kaufman,TX,Dallas-Fort Worth,43,953000,22162.79069767442,56,2041000,36446.42857142857,-13,-1088000
2020,county,48029,Bexar,48257,Kaufman,TX,Dallas-Fort Worth,62,1150000,18548.387096774193,102,2124000,20823.529411764706,-40,-974000
2020,county,48453,Travis,48259,Kendall,TX,Rural Texas,51,4593000,90058.82352941176,89,8284000,93078.65168539326,-38,-3691000
2020,county,48091,Comal,48259,Kendall,TX,Rural Texas,184,6731000,36581.52173913043,163,13029000,79932.51533742332,21,-6298000
2020,county,48029,Bexar,48259,Kendall,TX,Rural Texas,1095,57248000,52281.27853881279,1744,83738000,48014.908256880735,-649,-26490000
2020,county,48453,Travis,26081,Kent,MI,Rural Michigan,78,3035000,38910.256410256414,39,1132000,29025.641025641027,39,1903000
2020,county,48029,Bexar,26081,Kent,MI,Rural Michigan,62,1435000,23145.16129032258,49,1440000,29387.755102040817,13,-5000
2020,county,48029,Bexar,10001,Kent,DE,Rural Delaware,64,1185000,18515.625,70,2120000,30285.714285714286,-6,-935000
2020,county,48453,Travis,06029,Kern,CA,Rural California,53,2171000,40962.264150943396,37,729000,19702.702702702703,16,1442000
2020,county,48029,Bexar,06029,Kern,CA,Rural California,135,3041000,22525.925925925927,85,1777000,20905.882352941175,50,1264000
2020,county,48491,Williamson,48265,Kerr,TX,Rural Texas,78,2202000,28230.76923076923,45,1683000,37400.0,33,519000
2020,county,48453,Travis,48265,Kerr,TX,Rural Texas,107,3854000,36018.69158878505,102,5431000,53245.098039215685,5,-1577000
2020,county,48091,Comal,48265,Kerr,TX,Rural Texas,43,1687000,39232.558139534885,57,2263000,39701.754385964916,-14,-576000
2020,county,48029,Bexar,48265,Kerr,TX,Rural Texas,329,9762000,29671.732522796352,434,22816000,52571.42857142857,-105,-13054000
2020,county,48491,Williamson,53033,King,WA,Seattle,439,31530000,71822.32346241458,156,12089000,77493.58974358975,283,19441000
2020,county,48453,Travis,53033,King,WA,Seattle,949,81471000,85849.31506849315,650,54403000,83696.92307692308,299,27068000
2020,county,48029,Bexar,53033,King,WA,Seattle,349,17161000,49171.91977077364,288,15824000,54944.444444444445,61,1337000
2020,county,48491,Williamson,36047,Kings,NY,New York,111,4712000,42450.45045045045,29,1509000,52034.48275862069,82,3203000
2020,county,48453,Travis,36047,Kings,NY,New York,770,69308000,90010.38961038961,267,15423000,57764.04494382023,503,53885000
2020,county,48029,Bexar,36047,Kings,NY,New York,169,10514000,62213.01775147929,74,2658000,35918.91891891892,95,7856000
2020,county,48453,Travis,53035,Kitsap,WA,Rural Washington,40,2261000,56525.0,56,1684000,30071.428571428572,-16,577000
2020,county,48029,Bexar,53035,Kitsap,WA,Rural Washington,89,2455000,27584.26966292135,66,1587000,24045.454545454544,23,868000
2020,county,48029,Bexar,48273,Kleberg,TX,Rural Texas,101,2962000,29326.73267326733,95,1776000,18694.736842105263,6,1186000
2020,county,48453,Travis,47093,Knox,TN,Knoxville,44,2118000,48136.36363636364,68,2399000,35279.41176470588,-24,-281000
2020,county,48453,Travis,08067,La Plata,CO,Rural Colorado,27,1026000,38000.0,43,2607000,60627.90697674418,-16,-1581000
2020,county,48029,Bexar,48283,La Salle,TX,Rural Texas,52,1287000,24750.0,38,1225000,32236.842105263157,14,62000
2020,county,48453,Travis,22055,Lafayette Parish,LA,Rural Louisiana,61,2072000,33967.2131147541,52,1970000,37884.61538461538,9,102000
2020,county,48029,Bexar,22055,Lafayette Parish,LA,Rural Louisiana,40,1247000,31175.0,63,1893000,30047.619047619046,-23,-646000
2020,county,48453,Travis,17097,Lake,IL,Chicago,193,17557000,90968.91191709845,70,3344000,47771.42857142857,123,14213000
2020,county,48029,Bexar,17097,Lake,IL,Chicago,158,5172000,32734.177215189873,140,3030000,21642.85714285714,18,2142000
2020,county,48491,Williamson,48281,Lampasas,TX,Rural Texas,93,2185000,23494.62365591398,174,6565000,37729.88505747126,-81,-4380000
2020,county,48453,Travis,48281,Lampasas,TX,Rural Texas,59,1262000,21389.830508474577,93,-120401000,-1294634.4086021506,-34,121663000
2020,county,48453,Travis,41039,Lane,OR,Rural Oregon,57,1632000,28631.57894736842,46,2064000,44869.565217391304,11,-432000
2020,county,48029,Bexar,56021,Laramie,WY,Rural Wyoming,78,1928000,24717.94871794872,81,1750000,21604.938271604937,-3,178000
2020,county,48491,Williamson,08069,Larimer,CO,Rural Colorado,50,1941000,38820.0,50,2538000,50760.0,0,-597000
2020,county,48453,Travis,08069,Larimer,CO,Rural Colorado,99,4541000,45868.68686868687,135,8626000,63896.2962962963,-36,-4085000
2020,county,48029,Bexar,08069,Larimer,CO,Rural Colorado,62,2116000,34129.032258064515,81,4581000,56555.555555555555,-19,-2465000
2020,county,48491,Williamson,48287,Lee,TX,Rural Texas,58,1499000,25844.827586206895,128,4697000,36695.3125,-70,-3198000
2020,county,48491,Williamson,12071,Lee,FL,S.W. Florida,43,2076000,48279.06976744186,33,1725000,52272.72727272727,10,351000
2020,county,48453,Travis,12071,Lee,FL,S.W. Florida,70,3187000,45528.57142857143,65,3205000,49307.692307692305,5,-18000
2020,county,48453,Travis,48287,Lee,TX,Rural Texas,76,2204000,29000.0,149,4535000,30436.241610738256,-73,-2331000
2020,county,48029,Bexar,12071,Lee,FL,S.W. Florida,73,1644000,22520.54794520548,105,4143000,39457.142857142855,-32,-2499000
2020,county,48029,Bexar,13179,Liberty,GA,Rural Georgia,95,1830000,19263.157894736843,74,1511000,20418.91891891892,21,319000
2020,county,48029,Bexar,48297,Live Oak,TX,Rural Texas,45,906000,20133.333333333332,79,3454000,43721.51898734177,-34,-2548000
2020,county,48491,Williamson,48299,Llano,TX,Rural Texas,106,3589000,33858.49056603773,178,8063000,45297.752808988764,-72,-4474000
2020,county,48453,Travis,48299,Llano,TX,Rural Texas,78,4395000,56346.153846153844,225,20358000,90480.0,-147,-15963000
2020,county,48491,Williamson,06037,Los Angeles,CA,Los Angeles,905,42967000,47477.34806629834,158,4609000,29170.886075949365,747,38358000
2020,county,48453,Travis,06037,Los Angeles,CA,Los Angeles,2075,180682000,87075.6626506024,786,49694000,63223.91857506361,1289,130988000
2020,county,48209,Hays,06037,Los Angeles,CA,Los Angeles,221,11604000,52506.78733031674,51,1537000,30137.254901960783,170,10067000
2020,county,48091,Comal,06037,Los Angeles,CA,Los Angeles,138,7405000,53659.42028985507,36,1135000,31527.777777777777,102,6270000
2020,county,48029,Bexar,06037,Los Angeles,CA,Los Angeles,1303,44294000,33993.86032233308,545,19160000,35155.963302752294,758,25134000
2020,county,48453,Travis,51107,Loudoun,VA,Rural Virginia,97,5591000,57639.17525773196,44,2117000,48113.63636363636,53,3474000
2020,county,48029,Bexar,51107,Loudoun,VA,Rural Virginia,99,5286000,53393.93939393939,94,3690000,39255.31914893617,5,1596000
2020,county,48029,Bexar,13185,Lowndes,GA,Rural Georgia,81,1428000,17629.62962962963,55,1095000,19909.090909090908,26,333000
2020,county,48491,Williamson,48303,Lubbock,TX,Rural Texas,208,6029000,28985.576923076922,125,4048000,32384.0,83,1981000
2020,county,48453,Travis,48303,Lubbock,TX,Rural Texas,291,8716000,29951.89003436426,209,6071000,29047.846889952154,82,2645000
2020,county,48209,Hays,48303,Lubbock,TX,Rural Texas,57,1466000,25719.298245614034,64,1806000,28218.75,-7,-340000
2020,county,48029,Bexar,48303,Lubbock,TX,Rural Texas,387,10210000,26382.428940568476,359,8392000,23376.044568245125,28,1818000
2020,county,48029,Bexar,39095,Lucas,OH,Rural Ohio,58,831000,14327.586206896553,37,809000,21864.864864864863,21,22000
2020,county,48453,Travis,26099,Macomb,MI,Rural Michigan,42,1119000,26642.85714285714,59,2033000,34457.627118644064,-17,-914000
2020,county,48029,Bexar,26099,Macomb,MI,Rural Michigan,59,976000,16542.372881355932,39,1423000,36487.179487179485,20,-447000
2020,county,48453,Travis,01089,Madison,AL,Huntsville,42,2016000,48000.0,40,1917000,47925.0,2,99000
2020,county,48029,Bexar,01089,Madison,AL,Huntsville,87,3305000,37988.50574712644,63,2354000,37365.079365079364,24,951000
2020,county,48453,Travis,12081,Manatee,FL,Rural Florida,54,1296000,24000.0,39,2221000,56948.717948717946,15,-925000
2020,county,48491,Williamson,04013,Maricopa,AZ,Phoenix,421,17181000,40809.97624703088,347,15784000,45487.031700288186,74,1397000
2020,county,48453,Travis,04013,Maricopa,AZ,Phoenix,610,34763000,56988.524590163935,513,30794000,60027.29044834308,97,3969000
2020,county,48209,Hays,04013,Maricopa,AZ,Phoenix,109,3801000,34871.55963302752,112,3905000,34866.07142857143,-3,-104000
2020,county,48091,Comal,04013,Maricopa,AZ,Phoenix,98,6659000,67948.97959183673,38,2133000,56131.57894736842,60,4526000
2020,county,48029,Bexar,04013,Maricopa,AZ,Phoenix,769,25421000,33057.217165149545,774,32182000,41578.81136950904,-5,-6761000
2020,county,48453,Travis,06041,Marin,CA,Bay Area,126,15320000,121587.30158730158,51,4637000,90921.56862745098,75,10683000
2020,county,48453,Travis,18097,Marion,IN,Indianapolis,106,5240000,49433.96226415094,68,2915000,42867.64705882353,38,2325000
2020,county,48029,Bexar,18097,Marion,IN,Indianapolis,162,3132000,19333.333333333332,72,1717000,23847.222222222223,90,1415000
2020,county,48453,Travis,48323,Maverick,TX,Rural Texas,40,760000,19000.0,70,1048000,14971.42857142857,-30,-288000
2020,county,48029,Bexar,48323,Maverick,TX,Rural Texas,529,10110000,19111.531190926275,362,7146000,19740.331491712706,167,2964000
2020,county,48491,Williamson,48309,McLennan,TX,Rural Texas,280,6833000,24403.571428571428,218,8706000,39935.779816513765,62,-1873000
2020,county,48453,Travis,48309,McLennan,TX,Rural Texas,339,10034000,29598.82005899705,352,17372000,49352.27272727273,-13,-7338000
2020,county,48209,Hays,48309,McLennan,TX,Rural Texas,43,1038000,24139.53488372093,49,2018000,41183.67346938775,-6,-980000
2020,county,48029,Bexar,48309,McLennan,TX,Rural Texas,227,5210000,22951.541850220263,235,10922000,46476.59574468085,-8,-5712000
2020,county,48453,Travis,37119,Mecklenburg,NC,Charlotte,161,15185000,94316.7701863354,185,13346000,72140.54054054055,-24,1839000
2020,county,48029,Bexar,37119,Mecklenburg,NC,Charlotte,149,6142000,41221.476510067114,151,5565000,36854.30463576159,-2,577000
2020,county,48091,Comal,48325,Medina,TX,Rural Texas,57,1915000,33596.491228070176,37,1359000,36729.72972972973,20,556000
2020,county,48029,Bexar,48325,Medina,TX,Rural Texas,1279,32957000,25767.787333854572,2214,60001000,27100.722673893404,-935,-27044000
2020,county,48453,Travis,34021,Mercer,NJ,Rural New Jersey,42,4381000,104309.52380952382,39,1409000,36128.205128205125,3,2972000
2020,county,48491,Williamson,12086,Miami-Dade,FL,Miami,226,4326000,19141.59292035398,51,1344000,26352.941176470587,175,2982000
2020,county,48453,Travis,12086,Miami-Dade,FL,Miami,460,19360000,42086.95652173913,279,19655000,70448.02867383513,181,-295000
2020,county,48029,Bexar,12086,Miami-Dade,FL,Miami,315,8481000,26923.809523809523,188,5946000,31627.659574468085,127,2535000
2020,county,48453,Travis,25017,Middlesex,MA,Boston,374,27318000,73042.7807486631,201,12627000,62820.89552238806,173,14691000
2020,county,48453,Travis,34023,Middlesex,NJ,New York,122,9972000,81737.70491803279,65,4225000,65000.0,57,5747000
2020,county,48029,Bexar,25017,Middlesex,MA,Boston,106,4410000,41603.77358490566,86,6136000,71348.83720930232,20,-1726000
2020,county,48491,Williamson,48329,Midland,TX,Rural Texas,155,6755000,43580.645161290326,46,1345000,29239.130434782608,109,5410000
2020,county,48453,Travis,48329,Midland,TX,Rural Texas,182,13037000,71631.86813186813,117,6044000,51658.11965811966,65,6993000
2020,county,48209,Hays,48329,Midland,TX,Rural Texas,48,2668000,55583.333333333336,31,1251000,40354.83870967742,17,1417000
2020,county,48029,Bexar,48329,Midland,TX,Rural Texas,376,16315000,43390.95744680851,262,9281000,35423.6641221374,114,7034000
2020,county,48491,Williamson,48331,Milam,TX,Rural Texas,167,4055000,24281.437125748504,430,11327000,26341.86046511628,-263,-7272000
2020,county,48453,Travis,48331,Milam,TX,Rural Texas,79,1648000,20860.759493670885,137,4187000,30562.043795620437,-58,-2539000
2020,county,48453,Travis,55079,Milwaukee,WI,Milwaukee,117,4637000,39632.47863247863,75,2480000,33066.666666666664,42,2157000
2020,county,48029,Bexar,55079,Milwaukee,WI,Milwaukee,110,2179000,19809.090909090908,127,2178000,17149.6062992126,-17,1000
2020,county,48029,Bexar,01097,Mobile,AL,Mobile,51,513000,10058.823529411764,36,955000,26527.777777777777,15,-442000
2020,county,48029,Bexar,06053,Monterey,CA,Rural California,149,5967000,40046.97986577181,90,1882000,20911.11111111111,59,4085000
2020,county,48491,Williamson,48339,Montgomery,TX,Houston,337,13573000,40275.96439169139,252,10718000,42531.74603174603,85,2855000
2020,county,48453,Travis,48339,Montgomery,TX,Houston,524,33329000,63604.96183206107,474,22299000,47044.303797468354,50,11030000
2020,county,48453,Travis,24031,Montgomery,MD,D.C.,186,19560000,105161.29032258065,126,4864000,38603.1746031746,60,14696000
2020,county,48453,Travis,42091,Montgomery,PA,Philadelphia,38,2316000,60947.36842105263,57,3061000,53701.754385964916,-19,-745000
2020,county,48209,Hays,48339,Montgomery,TX,Houston,173,6859000,39647.398843930634,112,3519000,31419.64285714286,61,3340000
2020,county,48091,Comal,48339,Montgomery,TX,Houston,148,11671000,78858.1081081081,91,4146000,45560.43956043956,57,7525000
2020,county,48029,Bexar,48339,Montgomery,TX,Houston,398,19845000,49861.80904522613,442,17620000,39864.25339366516,-44,2225000
2020,county,48029,Bexar,24031,Montgomery,MD,D.C.,281,10633000,37839.857651245555,206,10745000,52160.19417475728,75,-112000
2020,county,48029,Bexar,39113,Montgomery,OH,Rural Ohio,185,5661000,30600.0,133,4320000,32481.203007518798,52,1341000
2020,county,48029,Bexar,47125,Montgomery,TN,Rural Tennessee,206,4033000,19577.66990291262,167,3807000,22796.40718562874,39,226000
2020,county,48029,Bexar,01101,Montgomery,AL,Montgomery,117,4030000,34444.444444444445,90,2746000,30511.11111111111,27,1284000
2020,county,48453,Travis,41051,Multnomah,OR,Portland,201,24842000,123592.03980099503,190,14527000,76457.8947368421,11,10315000
2020,county,48029,Bexar,41051,Multnomah,OR,Portland,85,3393000,39917.64705882353,62,2744000,44258.06451612903,23,649000
2020,county,48029,Bexar,13215,Muscogee,GA,Columbus,94,2268000,24127.659574468085,91,2191000,24076.923076923078,3,77000
2020,county,48453,Travis,36059,Nassau,NY,New York,135,8743000,64762.96296296296,28,1163000,41535.71428571428,107,7580000
2020,county,48453,Travis,10003,New Castle,DE,Rural Delaware,50,2690000,53800.0,54,2989000,55351.851851851854,-4,-299000
2020,county,48029,Bexar,10003,New Castle,DE,Rural Delaware,43,1432000,33302.32558139535,40,1872000,46800.0,3,-440000
2020,county,48453,Travis,09009,New Haven,CT,New Haven,62,2726000,43967.74193548387,53,2609000,49226.41509433962,9,117000
2020,county,48029,Bexar,09009,New Haven,CT,New Haven,61,2606000,42721.311475409835,48,1623000,33812.5,13,983000
2020,county,48491,Williamson,36061,New York,NY,New York,85,5813000,68388.23529411765,26,1772000,68153.84615384616,59,4041000
2020,county,48453,Travis,36061,New York,NY,New York,865,151207000,174805.7803468208,284,32564000,114661.97183098592,581,118643000
2020,county,48029,Bexar,36061,New York,NY,New York,155,17194000,110929.03225806452,87,8727000,100310.3448275862,68,8467000
2020,county,48029,Bexar,51700,Newport News city,VA,Hampton Roads,106,2318000,21867.924528301886,68,1463000,21514.70588235294,38,855000
2020,county,48453,Travis,25021,Norfolk,MA,Boston,104,6866000,66019.23076923077,52,2939000,56519.230769230766,52,3927000
2020,county,48029,Bexar,51710,Norfolk city,VA,Hampton Roads,109,2049000,18798.16513761468,84,1866000,22214.285714285714,25,183000
2020,county,48491,Williamson,48355,Nueces,TX,Rural Texas,218,6488000,29761.467889908257,198,6023000,30419.19191919192,20,465000
2020,county,48453,Travis,48355,Nueces,TX,Rural Texas,397,14231000,35846.3476070529,392,16783000,42813.77551020408,5,-2552000
2020,county,48209,Hays,48355,Nueces,TX,Rural Texas,150,3913000,26086.666666666668,108,3658000,33870.37037037037,42,255000
2020,county,48091,Comal,48355,Nueces,TX,Rural Texas,177,8403000,47474.57627118644,130,3238000,24907.69230769231,47,5165000
2020,county,48029,Bexar,48355,Nueces,TX,Rural Texas,1497,44882000,29981.295925183702,1066,31639000,29680.112570356472,431,13243000
2020,county,48453,Travis,26125,Oakland,MI,Detroit,165,7813000,47351.51515151515,85,4079000,47988.23529411765,80,3734000
2020,county,48029,Bexar,26125,Oakland,MI,Detroit,133,4618000,34721.8045112782,86,3120000,36279.06976744186,47,1498000
2020,county,48029,Bexar,12091,Okaloosa,FL,FL Panhandle,355,8893000,25050.704225352114,286,8620000,30139.86013986014,69,273000
2020,county,48491,Williamson,40109,Oklahoma,OK,Oklahoma City,88,3699000,42034.09090909091,61,1834000,30065.573770491803,27,1865000
2020,county,48453,Travis,40109,Oklahoma,OK,Oklahoma City,145,5676000,39144.8275862069,148,6391000,43182.43243243243,-3,-715000
2020,county,48029,Bexar,40109,Oklahoma,OK,Oklahoma City,276,8991000,32576.08695652174,227,6010000,26475.770925110133,49,2981000
2020,county,48029,Bexar,37133,Onslow,NC,Rural North Carolina,230,3864000,16800.0,116,2435000,20991.379310344826,114,1429000
2020,county,48491,Williamson,06059,Orange,CA,Los Angeles,560,26589000,47480.357142857145,120,5040000,42000.0,440,21549000
2020,county,48491,Williamson,12095,Orange,FL,Orlando,98,3376000,34448.97959183674,64,2836000,44312.5,34,540000
2020,county,48453,Travis,06059,Orange,CA,Los Angeles,775,51529000,66489.03225806452,292,20047000,68654.1095890411,483,31482000
2020,county,48453,Travis,12095,Orange,FL,Orlando,233,14844000,63708.15450643777,139,5587000,40194.24460431655,94,9257000
2020,county,48453,Travis,37135,Orange,NC,Raleigh,28,924000,33000.0,29,2073000,71482.75862068965,-1,-1149000
2020,county,48029,Bexar,06059,Orange,CA,Los Angeles,445,17110000,38449.43820224719,208,10655000,51225.96153846154,237,6455000
2020,county,48029,Bexar,12095,Orange,FL,Orlando,218,5223000,23958.715596330276,178,5714000,32101.123595505618,40,-491000
2020,county,48453,Travis,22071,Orleans Parish,LA,New Orleans,184,10646000,57858.69565217391,85,4282000,50376.470588235294,99,6364000
2020,county,48029,Bexar,22071,Orleans Parish,LA,New Orleans,88,4470000,50795.454545454544,77,2815000,36558.44155844156,11,1655000
2020,county,48029,Bexar,12097,Osceola,FL,Orlando,64,768000,12000.0,64,1410000,22031.25,0,-642000
2020,county,48029,Bexar,35035,Otero,NM,Rural New Mexico,118,2899000,24567.79661016949,109,2493000,22871.559633027522,9,406000
2020,county,48491,Williamson,12099,Palm Beach,FL,Miami,92,2865000,31141.304347826088,41,1811000,44170.73170731707,51,1054000
2020,county,48453,Travis,12099,Palm Beach,FL,Miami,179,8289000,46307.262569832405,132,9846000,74590.90909090909,47,-1557000
2020,county,48029,Bexar,12099,Palm Beach,FL,Miami,99,6670000,67373.73737373737,126,5529000,43880.95238095238,-27,1141000
2020,county,48491,Williamson,48367,Parker,TX,Dallas-Fort Worth,55,2290000,41636.36363636364,48,1906000,39708.333333333336,7,384000
2020,county,48453,Travis,48367,Parker,TX,Dallas-Fort Worth,27,822000,30444.444444444445,69,3493000,50623.188405797104,-42,-2671000
2020,county,48029,Bexar,48367,Parker,TX,Dallas-Fort Worth,42,1262000,30047.619047619046,74,4312000,58270.27027027027,-32,-3050000
2020,county,48453,Travis,12101,Pasco,FL,Tampa,50,1251000,25020.0,36,1106000,30722.222222222223,14,145000
2020,county,48029,Bexar,12101,Pasco,FL,Tampa,53,2144000,40452.83018867925,81,2678000,33061.72839506173,-28,-534000
2020,county,48029,Bexar,46103,Pennington,SD,Rural South Dakota,67,1600000,23880.597014925374,51,1567000,30725.49019607843,16,33000
2020,county,48453,Travis,42101,Philadelphia,PA,Philadelphia,182,12031000,66104.3956043956,99,5318000,53717.17171717172,83,6713000
2020,county,48029,Bexar,42101,Philadelphia,PA,Philadelphia,101,3256000,32237.62376237624,60,2758000,45966.666666666664,41,498000
2020,county,48491,Williamson,53053,Pierce,WA,Seattle,132,5032000,38121.21212121212,44,1490000,33863.63636363636,88,3542000
2020,county,48453,Travis,53053,Pierce,WA,Seattle,106,3035000,28632.075471698114,103,4076000,39572.81553398058,3,-1041000
2020,county,48029,Bexar,53053,Pierce,WA,Seattle,511,13197000,25825.83170254403,431,9444000,21911.83294663573,80,3753000
2020,county,48491,Williamson,04019,Pima,AZ,Tucson,97,3825000,39432.989690721646,58,1600000,27586.206896551725,39,2225000
2020,county,48453,Travis,04019,Pima,AZ,Tucson,122,5997000,49155.737704918036,100,5137000,51370.0,22,860000
2020,county,48029,Bexar,04019,Pima,AZ,Tucson,361,11228000,31102.493074792244,256,7097000,27722.65625,105,4131000
2020,county,48029,Bexar,04021,Pinal,AZ,Phoenix,75,1802000,24026.666666666668,68,1592000,23411.764705882353,7,210000
2020,county,48491,Williamson,12103,Pinellas,FL,Tampa,43,1020000,23720.93023255814,56,2633000,47017.857142857145,-13,-1613000
2020,county,48453,Travis,12103,Pinellas,FL,Tampa,86,3978000,46255.813953488374,135,9122000,67570.37037037036,-49,-5144000
2020,county,48029,Bexar,12103,Pinellas,FL,Tampa,99,3490000,35252.52525252525,78,3150000,40384.61538461538,21,340000
2020,county,48029,Bexar,06061,Placer,CA,Sacramento,92,3737000,40619.565217391304,73,2465000,33767.12328767123,19,1272000
2020,county,48453,Travis,12105,Polk,FL,Orlando,48,1098000,22875.0,34,772000,22705.882352941175,14,326000
2020,county,48453,Travis,48373,Polk,TX,Rural Texas,54,2242000,41518.51851851852,70,3556000,50800.0,-16,-1314000
2020,county,48029,Bexar,12105,Polk,FL,Orlando,93,1469000,15795.698924731183,68,1496000,22000.0,25,-27000
2020,county,48029,Bexar,48373,Polk,TX,Rural Texas,60,3582000,59700.0,65,3621000,55707.692307692305,-5,-39000
2020,county,48029,Bexar,19153,Polk,IA,Rural Iowa,51,1485000,29117.647058823528,38,960000,25263.157894736843,13,525000
2020,county,48029,Bexar,48375,Potter,TX,Rural Texas,81,1359000,16777.777777777777,45,852000,18933.333333333332,36,507000
2020,county,48453,Travis,24033,Prince George,MD,Rural Maryland,80,3018000,37725.0,44,1308000,29727.272727272728,36,1710000
2020,county,48029,Bexar,24033,Prince George,MD,Rural Maryland,215,7004000,32576.74418604651,104,3899000,37490.38461538462,111,3105000
2020,county,48453,Travis,51153,Prince William,VA,Rural Virginia,50,3273000,65460.0,39,1542000,39538.46153846154,11,1731000
2020,county,48029,Bexar,51153,Prince William,VA,Rural Virginia,190,6872000,36168.42105263158,113,4210000,37256.63716814159,77,2662000
2020,county,48453,Travis,44007,Providence,RI,Providence,60,3328000,55466.666666666664,32,1257000,39281.25,28,2071000
2020,county,48453,Travis,05119,Pulaski,AR,Little Rock,67,2496000,37253.73134328358,64,2568000,40125.0,3,-72000
2020,county,48029,Bexar,05119,Pulaski,AR,Little Rock,100,2174000,21740.0,80,2714000,33925.0,20,-540000
2020,county,48029,Bexar,29169,Pulaski,MO,Rural Missouri,87,1832000,21057.471264367818,103,2529000,24553.398058252427,-16,-697000
2020,county,48453,Travis,36081,Queens,NY,New York,324,15326000,47302.46913580247,70,2608000,37257.142857142855,254,12718000
2020,county,48029,Bexar,36081,Queens,NY,New York,143,4155000,29055.944055944055,70,2420000,34571.42857142857,73,1735000
2020,county,48453,Travis,27123,Ramsey,MN,Minneapolis,68,5394000,79323.5294117647,35,1236000,35314.28571428572,33,4158000
2020,county,48029,Bexar,27123,Ramsey,MN,Minneapolis,60,2338000,38966.666666666664,40,1904000,47600.0,20,434000
2020,county,48491,Williamson,48381,Randall,TX,Rural Texas,59,1652000,28000.0,44,1347000,30613.636363636364,15,305000
2020,county,48453,Travis,48381,Randall,TX,Rural Texas,65,2178000,33507.692307692305,53,1734000,32716.98113207547,12,444000
2020,county,48029,Bexar,48381,Randall,TX,Rural Texas,166,4344000,26168.67469879518,88,2941000,33420.454545454544,78,1403000
2020,county,48029,Bexar,45079,Richland,SC,Columbia,122,3313000,27155.737704918032,112,2384000,21285.714285714286,10,929000
2020,county,48029,Bexar,13245,Richmond,GA,Rural Georgia,99,2506000,25313.131313131315,101,2739000,27118.811881188118,-2,-233000
2020,county,48453,Travis,51760,Richmond city,VA,Richmond,35,1371000,39171.42857142857,31,1835000,59193.54838709677,4,-464000
2020,county,48029,Bexar,20161,Riley,KS,Rural Kansas,58,1740000,30000.0,36,981000,27250.0,22,759000
2020,county,48491,Williamson,06065,Riverside,CA,San Bernardino-Riverside,306,10659000,34833.333333333336,55,1481000,26927.272727272728,251,9178000
2020,county,48453,Travis,06065,Riverside,CA,San Bernardino-Riverside,249,8017000,32196.787148594376,149,5646000,37892.61744966443,100,2371000
2020,county,48029,Bexar,06065,Riverside,CA,San Bernardino-Riverside,443,11226000,25340.857787810382,220,5621000,25550.0,223,5605000
2020,county,48453,Travis,48397,Rockwall,TX,Dallas-Fort Worth,63,5527000,87730.15873015873,80,3318000,41475.0,-17,2209000
2020,county,48491,Williamson,06067,Sacramento,CA,Sacramento,197,7202000,36558.37563451777,49,1587000,32387.755102040817,148,5615000
2020,county,48453,Travis,06067,Sacramento,CA,Sacramento,194,10572000,54494.845360824744,100,5822000,58220.0,94,4750000
2020,county,48029,Bexar,06067,Sacramento,CA,Sacramento,256,8267000,32292.96875,116,3557000,30663.793103448275,140,4710000
2020,county,48491,Williamson,49035,Salt Lake,UT,Salt Lake,132,5229000,39613.63636363636,110,2788000,25345.454545454544,22,2441000
2020,county,48453,Travis,49035,Salt Lake,UT,Salt Lake,204,9747000,47779.41176470588,166,9304000,56048.19277108434,38,443000
2020,county,48029,Bexar,49035,Salt Lake,UT,Salt Lake,228,6321000,27723.684210526317,166,5834000,35144.57831325301,62,487000
2020,county,48491,Williamson,06071,San Bernardino,CA,San Bernardino-Riverside,179,4838000,27027.932960893853,45,509000,11311.111111111111,134,4329000
2020,county,48453,Travis,06071,San Bernardino,CA,San Bernardino-Riverside,184,5780000,31413.043478260868,70,1487000,21242.85714285714,114,4293000
2020,county,48029,Bexar,06071,San Bernardino,CA,San Bernardino-Riverside,425,9832000,23134.117647058825,204,5761000,28240.196078431374,221,4071000
2020,county,48491,Williamson,06073,San Diego,CA,San Diego,576,24288000,42166.666666666664,145,6634000,45751.724137931036,431,17654000
2020,county,48453,Travis,06073,San Diego,CA,San Diego,982,91129000,92799.38900203667,440,19511000,44343.181818181816,542,71618000
2020,county,48209,Hays,06073,San Diego,CA,San Diego,121,9568000,79074.38016528926,44,1250000,28409.090909090908,77,8318000
2020,county,48091,Comal,06073,San Diego,CA,San Diego,190,8321000,43794.73684210526,39,898000,23025.641025641027,151,7423000
2020,county,48029,Bexar,06073,San Diego,CA,San Diego,1176,33176000,28210.884353741498,645,18148000,28136.434108527134,531,15028000
2020,county,48453,Travis,06075,San Francisco,CA,Bay Area,938,168852000,180012.79317697228,198,19061000,96267.67676767676,740,149791000
2020,county,48029,Bexar,06075,San Francisco,CA,Bay Area,70,6305000,90071.42857142857,39,1906000,48871.794871794875,31,4399000
2020,county,48453,Travis,06081,San Mateo,CA,Bay Area,566,141094000,249282.6855123675,132,20553000,155704.54545454544,434,120541000
2020,county,48029,Bexar,06081,San Mateo,CA,Bay Area,51,2547000,49941.17647058824,35,1516000,43314.28571428572,16,1031000
2020,county,48453,Travis,48409,San Patricio,TX,Rural Texas,62,1951000,31467.74193548387,52,1256000,24153.846153846152,10,695000
2020,county,48029,Bexar,48409,San Patricio,TX,Rural Texas,219,5225000,23858.447488584476,201,5066000,25203.98009950249,18,159000
2020,county,48453,Travis,06083,Santa Barbara,CA,Rural California,142,6733000,47415.49295774648,47,2501000,53212.765957446805,95,4232000
2020,county,48029,Bexar,06083,Santa Barbara,CA,Rural California,81,2473000,30530.864197530864,57,1412000,24771.929824561405,24,1061000
2020,county,48491,Williamson,06085,Santa Clara,CA,Bay Area,1155,88612000,76720.34632034632,95,10399000,109463.15789473684,1060,78213000
2020,county,48453,Travis,06085,Santa Clara,CA,Bay Area,1685,181727000,107849.85163204747,421,39005000,92648.45605700712,1264,142722000
2020,county,48029,Bexar,06085,Santa Clara,CA,Bay Area,231,13467000,58298.7012987013,106,5058000,47716.981132075474,125,8409000
2020,county,48453,Travis,35049,Santa Fe,NM,Rural New Mexico,34,1943000,57147.05882352941,103,9537000,92592.23300970874,-69,-7594000
2020,county,48029,Bexar,35049,Santa Fe,NM,Rural New Mexico,32,832000,26000.0,39,2701000,69256.41025641025,-7,-1869000
2020,county,48029,Bexar,12113,Santa Rosa,FL,FL Panhandle,120,3568000,29733.333333333332,107,4134000,38635.51401869159,13,-566000
2020,county,48453,Travis,12115,Sarasota,FL,S.W. Florida,47,2638000,56127.65957446808,59,3905000,66186.44067796611,-12,-1267000
2020,county,48029,Bexar,31153,Sarpy,NE,Omaha,160,4314000,26962.5,124,2820000,22741.935483870966,36,1494000
2020,county,48453,Travis,20173,Sedgwick,KS,Rural Kansas,90,3807000,42300.0,33,1655000,50151.51515151515,57,2152000
2020,county,48029,Bexar,20173,Sedgwick,KS,Rural Kansas,147,3851000,26197.278911564626,106,2287000,21575.471698113208,41,1564000
2020,county,48453,Travis,12117,Seminole,FL,Orlando,63,3342000,53047.619047619046,34,1611000,47382.35294117647,29,1731000
2020,county,48029,Bexar,12117,Seminole,FL,Orlando,71,2086000,29380.281690140844,68,2133000,31367.647058823528,3,-47000
2020,county,48491,Williamson,47157,Shelby,TN,Memphis,46,2832000,61565.217391304344,57,1081000,18964.912280701756,-11,1751000
2020,county,48453,Travis,47157,Shelby,TN,Memphis,98,3830000,39081.63265306123,99,4103000,41444.444444444445,-1,-273000
2020,county,48029,Bexar,47157,Shelby,TN,Memphis,165,4053000,24563.636363636364,105,3529000,33609.52380952381,60,524000
2020,county,48491,Williamson,48423,Smith,TX,Rural Texas,111,3042000,27405.405405405407,114,3824000,33543.85964912281,-3,-782000
2020,county,48453,Travis,48423,Smith,TX,Rural Texas,122,5029000,41221.311475409835,143,5791000,40496.503496503494,-21,-762000
2020,county,48029,Bexar,48423,Smith,TX,Rural Texas,133,2939000,22097.744360902256,157,4374000,27859.87261146497,-24,-1435000
2020,county,48491,Williamson,53061,Snohomish,WA,Seattle,96,5865000,61093.75,40,2006000,50150.0,56,3859000
2020,county,48453,Travis,53061,Snohomish,WA,Seattle,116,5372000,46310.34482758621,95,3640000,38315.78947368421,21,1732000
2020,county,48029,Bexar,53061,Snohomish,WA,Seattle,259,11093000,42830.11583011583,123,3535000,28739.837398373984,136,7558000
2020,county,48029,Bexar,06095,Solano,CA,Bay Area,248,7200000,29032.25806451613,192,4803000,25015.625,56,2397000
2020,county,48453,Travis,06097,Sonoma,CA,Bay Area,85,5937000,69847.05882352941,42,2419000,57595.23809523809,43,3518000
2020,county,48453,Travis,53063,Spokane,WA,Spokane,49,1589000,32428.571428571428,36,1383000,38416.666666666664,13,206000
2020,county,48029,Bexar,53063,Spokane,WA,Spokane,90,2335000,25944.444444444445,91,3116000,34241.758241758245,-1,-781000
2020,county,48029,Bexar,17163,St. Clair,IL,St. Louis,180,4442000,24677.777777777777,181,4403000,24325.96685082873,-1,39000
2020,county,48453,Travis,29189,St. Louis,MO,St. Louis,152,25493000,167717.1052631579,83,4376000,52722.89156626506,69,21117000
2020,county,48029,Bexar,29189,St. Louis,MO,St. Louis,137,5829000,42547.44525547445,97,3214000,33134.0206185567,40,2615000
2020,county,48453,Travis,29510,St. Louis city,MO,Rural Missouri,56,3042000,54321.42857142857,41,1961000,47829.26829268293,15,1081000
2020,county,48029,Bexar,29510,St. Louis city,MO,Rural Missouri,43,1409000,32767.441860465115,40,3646000,91150.0,3,-2237000
2020,county,48029,Bexar,22103,St. Tammany Parish,LA,New Orleans,59,2109000,35745.76271186441,56,1815000,32410.714285714286,3,294000
2020,county,48029,Bexar,06099,Stanislaus,CA,Bay Area,71,1130000,15915.492957746479,53,980000,18490.56603773585,18,150000
2020,county,48029,Bexar,48427,Starr,TX,Rural Texas,95,1971000,20747.36842105263,64,1415000,22109.375,31,556000
2020,county,48453,Travis,25025,Suffolk,MA,Boston,270,21303000,78900.0,74,4990000,67432.43243243243,196,16313000
2020,county,48453,Travis,36103,Suffolk,NY,New York,126,8637000,68547.61904761905,59,3789000,64220.338983050846,67,4848000
2020,county,48029,Bexar,25025,Suffolk,MA,Boston,53,2761000,52094.339622641506,49,1721000,35122.448979591834,4,1040000
2020,county,48029,Bexar,36103,Suffolk,NY,New York,64,2250000,35156.25,37,1815000,49054.05405405405,27,435000
2020,county,48029,Bexar,45085,Sumter,SC,Rural South Carolina,70,1749000,24985.714285714286,110,1925000,17500.0,-40,-176000
2020,county,48491,Williamson,48439,Tarrant,TX,Dallas-Fort Worth,644,29207000,45352.48447204969,468,17141000,36626.068376068375,176,12066000
2020,county,48453,Travis,48439,Tarrant,TX,Dallas-Fort Worth,1188,66719000,56160.77441077441,1146,50998000,44500.87260034904,42,15721000
2020,county,48209,Hays,48439,Tarrant,TX,Dallas-Fort Worth,220,15734000,71518.18181818182,205,5294000,25824.39024390244,15,10440000
2020,county,48091,Comal,48439,Tarrant,TX,Dallas-Fort Worth,134,6916000,51611.94029850746,111,4554000,41027.02702702703,23,2362000
2020,county,48029,Bexar,48439,Tarrant,TX,Dallas-Fort Worth,1060,26649000,25140.56603773585,1325,41235000,31120.754716981133,-265,-14586000
2020,county,48491,Williamson,48441,Taylor,TX,Rural Texas,94,2929000,31159.574468085106,91,4583000,50362.63736263736,3,-1654000
2020,county,48453,Travis,48441,Taylor,TX,Rural Texas,108,4578000,42388.88888888889,122,4646000,38081.96721311475,-14,-68000
2020,county,48029,Bexar,48441,Taylor,TX,Rural Texas,309,7115000,23025.88996763754,231,4916000,21281.385281385283,78,2199000
2020,county,48453,Travis,53067,Thurston,WA,Rural Washington,43,1934000,44976.74418604651,44,1672000,38000.0,-1,262000
2020,county,48029,Bexar,53067,Thurston,WA,Rural Washington,155,3190000,20580.645161290322,138,3818000,27666.666666666668,17,-628000
2020,county,48491,Williamson,48451,Tom Green,TX,Rural Texas,121,3139000,25942.14876033058,86,2532000,29441.86046511628,35,607000
2020,county,48453,Travis,48451,Tom Green,TX,Rural Texas,97,3698000,38123.71134020619,111,3054000,27513.513513513513,-14,644000
2020,county,48029,Bexar,48451,Tom Green,TX,Rural Texas,399,9396000,23548.872180451126,223,6160000,27623.318385650226,176,3236000
2020,county,48491,Williamson,48453,Travis,TX,Austin,22997,964876000,41956.6030351785,14146,555689000,39282.41198925491,8851,409187000
2020,county,48209,Hays,48453,Travis,TX,Austin,9286,403434000,43445.40167994831,4015,138890000,34592.77708592777,5271,264544000
2020,county,48091,Comal,48453,Travis,TX,Austin,773,40167000,51962.48382923674,375,17138000,45701.333333333336,398,23029000
2020,county,48029,Bexar,48453,Travis,TX,Austin,2549,211894000,83128.28560219693,2689,125461000,46657.12160654518,-140,86433000
2020,county,48491,Williamson,40143,Tulsa,OK,Tulsa,47,2027000,43127.65957446808,69,2889000,41869.565217391304,-22,-862000
2020,county,48453,Travis,40143,Tulsa,OK,Tulsa,138,6982000,50594.20289855073,125,4773000,38184.0,13,2209000
2020,county,48029,Bexar,40143,Tulsa,OK,Tulsa,139,3192000,22964.02877697842,92,3038000,33021.739130434784,47,154000
2020,county,48491,Williamson,49049,Utah,UT,Rural Utah,150,4992000,33280.0,81,2287000,28234.567901234568,69,2705000
2020,county,48453,Travis,49049,Utah,UT,Rural Utah,88,2837000,32238.636363636364,93,3329000,35795.69892473118,-5,-492000
2020,county,48029,Bexar,49049,Utah,UT,Rural Utah,181,2970000,16408.839779005524,120,2717000,22641.666666666668,61,253000
2020,county,48029,Bexar,48463,Uvalde,TX,Rural Texas,252,5501000,21829.365079365078,202,20709000,102519.80198019803,50,-15208000
2020,county,48453,Travis,48465,Val Verde,TX,Rural Texas,54,1441000,26685.185185185186,40,1476000,36900.0,14,-35000
2020,county,48029,Bexar,48465,Val Verde,TX,Rural Texas,367,9691000,26405.99455040872,258,6442000,24968.992248062015,109,3249000
2020,county,48491,Williamson,06111,Ventura,CA,Los Angeles,132,8759000,66356.06060606061,39,958000,24564.102564102563,93,7801000
2020,county,48453,Travis,06111,Ventura,CA,Los Angeles,207,13288000,64193.23671497584,81,6344000,78320.98765432098,126,6944000
2020,county,48029,Bexar,06111,Ventura,CA,Los Angeles,146,4758000,32589.04109589041,88,2623000,29806.81818181818,58,2135000
2020,county,48029,Bexar,22115,Vernon Parish,LA,Rural Louisiana,149,2865000,19228.187919463086,74,1615000,21824.324324324323,75,1250000
2020,county,48491,Williamson,48469,Victoria,TX,Rural Texas,82,2526000,30804.878048780487,65,1762000,27107.69230769231,17,764000
2020,county,48453,Travis,48469,Victoria,TX,Rural Texas,123,3534000,28731.70731707317,72,2183000,30319.444444444445,51,1351000
2020,county,48209,Hays,48469,Victoria,TX,Rural Texas,52,1683000,32365.384615384617,45,1048000,23288.88888888889,7,635000
2020,county,48029,Bexar,48469,Victoria,TX,Rural Texas,192,6715000,34973.958333333336,153,6083000,39758.16993464052,39,632000
2020,county,48453,Travis,51810,Virginia Beach city,VA,Hampton Roads,40,1353000,33825.0,31,2012000,64903.22580645161,9,-659000
2020,county,48029,Bexar,51810,Virginia Beach city,VA,Hampton Roads,187,4874000,26064.171122994652,131,3030000,23129.77099236641,56,1844000
2020,county,48453,Travis,12127,Volusia,FL,Atlantic Coast,40,1499000,37475.0,39,1495000,38333.333333333336,1,4000
2020,county,48029,Bexar,12127,Volusia,FL,Atlantic Coast,46,1117000,24282.608695652172,69,2053000,29753.623188405796,-23,-936000
2020,county,48491,Williamson,37183,Wake,NC,Raleigh,100,6528000,65280.0,109,5717000,52449.54128440367,-9,811000
2020,county,48453,Travis,37183,Wake,NC,Raleigh,241,27707000,114966.80497925311,222,16196000,72954.95495495496,19,11511000
2020,county,48029,Bexar,37183,Wake,NC,Raleigh,107,3928000,36710.280373831774,147,6705000,45612.244897959186,-40,-2777000
2020,county,48453,Travis,48471,Walker,TX,Rural Texas,45,1278000,28400.0,40,996000,24900.0,5,282000
2020,county,48029,Bexar,48471,Walker,TX,Rural Texas,62,1788000,28838.709677419356,43,989000,23000.0,19,799000
2020,county,48029,Bexar,38101,Ward,ND,Rural North Dakota,114,3000000,26315.78947368421,77,2009000,26090.909090909092,37,991000
2020,county,48491,Williamson,41067,Washington,OR,Portland,103,7393000,71776.69902912622,66,1574000,23848.484848484848,37,5819000
2020,county,48453,Travis,41067,Washington,OR,Portland,205,14211000,69321.9512195122,133,7958000,59834.58646616541,72,6253000
2020,county,48453,Travis,05143,Washington,AR,Rural Arkansas,55,2343000,42600.0,63,2727000,43285.71428571428,-8,-384000
2020,county,48453,Travis,48477,Washington,TX,Rural Texas,55,1655000,30090.909090909092,59,3440000,58305.08474576271,-4,-1785000
2020,county,48029,Bexar,41067,Washington,OR,Portland,70,4131000,59014.28571428572,73,2385000,32671.23287671233,-3,1746000
2020,county,48453,Travis,32031,Washoe,NV,Rural Nevada,91,6433000,70692.30769230769,61,3629000,59491.80327868852,30,2804000
2020,county,48029,Bexar,32031,Washoe,NV,Rural Nevada,95,3300000,34736.84210526316,66,2230000,33787.878787878784,29,1070000
2020,county,48453,Travis,26161,Washtenaw,MI,Rural Michigan,92,5237000,56923.913043478264,41,3650000,89024.39024390244,51,1587000
2020,county,48491,Williamson,26163,Wayne,MI,Detroit,37,1459000,39432.43243243243,47,970000,20638.297872340427,-10,489000
2020,county,48453,Travis,26163,Wayne,MI,Detroit,119,6554000,55075.63025210084,256,2845000,11113.28125,-137,3709000
2020,county,48029,Bexar,26163,Wayne,MI,Detroit,103,3202000,31087.3786407767,130,1622000,12476.923076923076,-27,1580000
2020,county,48491,Williamson,48479,Webb,TX,Rural Texas,85,2590000,30470.58823529412,32,1535000,47968.75,53,1055000
2020,county,48453,Travis,48479,Webb,TX,Rural Texas,205,4061000,19809.756097560974,132,4683000,35477.27272727273,73,-622000
2020,county,48029,Bexar,48479,Webb,TX,Rural Texas,1453,33530000,23076.39366827254,711,13023000,18316.45569620253,742,20507000
2020,county,48029,Bexar,08123,Weld,CO,Rural Colorado,55,1318000,23963.636363636364,40,823000,20575.0,15,495000
2020,county,48453,Travis,36119,Westchester,NY,New York,139,12394000,89165.46762589928,50,4202000,84040.0,89,8192000
2020,county,48453,Travis,48485,Wichita,TX,Rural Texas,58,2099000,36189.65517241379,75,3159000,42120.0,-17,-1060000
2020,county,48029,Bexar,48485,Wichita,TX,Rural Texas,133,3842000,28887.218045112782,98,3096000,31591.836734693876,35,746000
2020,county,48453,Travis,48491,Williamson,TX,Austin,14146,555689000,39282.41198925491,22997,964876000,41956.6030351785,-8851,-409187000
2020,county,48453,Travis,47187,Williamson,TN,Nashville,57,4701000,82473.68421052632,88,5514000,62659.09090909091,-31,-813000
2020,county,48209,Hays,48491,Williamson,TX,Austin,959,33174000,34592.28362877998,763,27759000,36381.38925294889,196,5415000
2020,county,48091,Comal,48491,Williamson,TX,Austin,254,10920000,42992.12598425197,206,7014000,34048.54368932039,48,3906000
2020,county,48029,Bexar,48491,Williamson,TX,Austin,884,28588000,32339.366515837104,1117,38279000,34269.471799462845,-233,-9691000
2020,county,48091,Comal,48493,Wilson,TX,Rural Texas,105,7557000,71971.42857142857,158,8880000,56202.53164556962,-53,-1323000
2020,county,48029,Bexar,48493,Wilson,TX,Rural Texas,1097,26427000,24090.24612579763,2037,57658000,28305.351006381934,-940,-31231000
2020,county,48453,Travis,25027,Worcester,MA,Rural Massachusetts,83,4814000,58000.0,54,3077000,56981.48148148148,29,1737000
2020,county,48453,Travis,04025,Yavapai,AZ,Rural Arizona,29,652000,22482.758620689656,27,1213000,44925.92592592593,2,-561000
2020,county,48029,Bexar,51199,York,VA,Hampton Roads,118,3009000,25500.0,74,1856000,25081.08108108108,44,1153000
2020,county,48029,Bexar,48507,Zavala,TX,Rural Texas,70,1158000,16542.85714285714,65,1045000,16076.923076923076,5,113000
2020,total,48491,Williamson,96000,,,,59019,2430476000,41181.24671715888,38702,1456935000,37644.95374916025,20317,973541000
2020,total,48453,Travis,96000,,,,82690,5205565000,62952.775426290966,85515,4257276000,49783.96772496053,-2825,948289000
2020,total,48209,Hays,96000,,,,22470,943999000,42011.52647975078,15442,501102000,32450.5893019039,7028,442897000
2020,total,48091,Comal,96000,,,,19635,867144000,44163.177998472114,11624,422368000,36335.8568479009,8011,444776000
2020,total,48029,Bexar,96000,,,,86358,2864826000,33173.83450288334,82831,2722616000,32869.529523970494,3527,142210000
2021,county,48453,Travis,16001,Ada,ID,Rural Idaho,72,3787000,52597.22222222222,142,6993000,49246.47887323944,-70,-3206000
2021,county,48029,Bexar,16001,Ada,ID,Rural Idaho,65,2834000,43600.0,93,3543000,38096.77419354839,-28,-709000
2021,county,48453,Travis,08001,Adams,CO,Denver,74,3252000,43945.94594594595,91,4280000,47032.96703296703,-17,-1028000
2021,county,48029,Bexar,08001,Adams,CO,Denver,177,5202000,29389.830508474577,94,2880000,30638.297872340427,83,2322000
2021,county,48453,Travis,12001,Alachua,FL,Rural Florida,57,2429000,42614.0350877193,36,1466000,40722.22222222222,21,963000
2021,county,48491,Williamson,06001,Alameda,CA,Bay Area,687,59115000,86048.03493449782,41,1946000,47463.41463414634,646,57169000
2021,county,48453,Travis,06001,Alameda,CA,Bay Area,934,170904000,182980.72805139187,202,19450000,96287.12871287129,732,151454000
2021,county,48029,Bexar,06001,Alameda,CA,Bay Area,201,11120000,55323.383084577115,77,3691000,47935.06493506493,124,7429000
2021,county,48453,Travis,51510,Alexandria city,VA,D.C.,58,5373000,92637.93103448275,46,3099000,67369.56521739131,12,2274000
2021,county,48029,Bexar,51510,Alexandria city,VA,D.C.,71,4609000,64915.49295774648,60,2473000,41216.666666666664,11,2136000
2021,county,48491,Williamson,42003,Allegheny,PA,Pittsburgh,62,3640000,58709.67741935484,41,1247000,30414.634146341465,21,2393000
2021,county,48453,Travis,42003,Allegheny,PA,Pittsburgh,134,10665000,79589.55223880598,124,6630000,53467.74193548387,10,4035000
2021,county,48029,Bexar,42003,Allegheny,PA,Pittsburgh,70,3560000,50857.142857142855,69,2366000,34289.85507246377,1,1194000
2021,county,48453,Travis,02020,Anchorage Borough,AK,Rural Alaska,45,1918000,42622.22222222222,29,1104000,38068.96551724138,16,814000
2021,county,48029,Bexar,02020,Anchorage Borough,AK,Rural Alaska,222,6839000,30806.306306306305,176,6060000,34431.818181818184,46,779000
2021,county,48029,Bexar,48001,Anderson,TX,Rural Texas,36,279000,7750.0,36,292000,8111.111111111111,0,-13000
2021,county,48453,Travis,48005,Angelina,TX,Rural Texas,43,2224000,51720.93023255814,51,1442000,28274.50980392157,-8,782000
2021,county,48029,Bexar,48005,Angelina,TX,Rural Texas,43,861000,20023.25581395349,47,1490000,31702.127659574468,-4,-629000
2021,county,48453,Travis,24003,Anne Arundel,MD,Baltimore,87,5124000,58896.55172413793,37,1960000,52972.97297297297,50,3164000
2021,county,48029,Bexar,24003,Anne Arundel,MD,Baltimore,401,14448000,36029.92518703242,292,8779000,30065.068493150684,109,5669000
2021,county,48453,Travis,48007,Aransas,TX,Rural Texas,28,1203000,42964.28571428572,69,3951000,57260.86956521739,-41,-2748000
2021,county,48029,Bexar,48007,Aransas,TX,Rural Texas,66,1685000,25530.303030303032,164,7019000,42798.78048780488,-98,-5334000
2021,county,48491,Williamson,08005,Arapahoe,CO,Denver,56,2734000,48821.42857142857,82,3454000,42121.95121951219,-26,-720000
2021,county,48453,Travis,08005,Arapahoe,CO,Denver,153,9694000,63359.47712418301,200,9811000,49055.0,-47,-117000
2021,county,48029,Bexar,08005,Arapahoe,CO,Denver,214,7237000,33817.7570093458,206,14106000,68475.7281553398,8,-6869000
2021,county,48453,Travis,51013,Arlington,VA,D.C.,158,19873000,125778.48101265823,95,6677000,70284.21052631579,63,13196000
2021,county,48029,Bexar,51013,Arlington,VA,D.C.,101,7055000,69851.48514851485,59,4059000,68796.61016949153,42,2996000
2021,county,48029,Bexar,48013,Atascosa,TX,Rural Texas,1374,36693000,26705.24017467249,2084,40061000,19223.12859884837,-710,-3368000
2021,county,48453,Travis,24005,Baltimore,MD,Baltimore,58,3533000,60913.793103448275,30,1719000,57300.0,28,1814000
2021,county,48029,Bexar,24005,Baltimore,MD,Baltimore,105,3611000,34390.47619047619,46,1658000,36043.47826086957,59,1953000
2021,county,48453,Travis,24510,Baltimore city,MD,Baltimore,82,6883000,83939.0243902439,44,2528000,57454.545454545456,38,4355000
2021,county,48029,Bexar,24510,Baltimore city,MD,Baltimore,58,2032000,35034.48275862069,44,2352000,53454.545454545456,14,-320000
2021,county,48029,Bexar,48019,Bandera,TX,Rural Texas,338,9559000,28281.065088757397,676,24624000,36426.03550295858,-338,-15065000
2021,county,48491,Williamson,48021,Bastrop,TX,Austin,454,12258000,27000.0,731,26601000,36389.87688098495,-277,-14343000
2021,county,48453,Travis,48021,Bastrop,TX,Austin,1489,34677000,23288.784419073203,4274,113575000,26573.467477772578,-2785,-78898000
2021,county,48209,Hays,48021,Bastrop,TX,Austin,273,7031000,25754.578754578753,395,9668000,24475.949367088608,-122,-2637000
2021,county,48091,Comal,48021,Bastrop,TX,Austin,74,2265000,30608.108108108107,35,2762000,78914.28571428571,39,-497000
2021,county,48029,Bexar,48021,Bastrop,TX,Austin,121,2956000,24429.752066115703,128,3878000,30296.875,-7,-922000
2021,county,48029,Bexar,12005,Bay,FL,FL Panhandle,81,2276000,28098.765432098764,112,2812000,25107.14285714286,-31,-536000
2021,county,48453,Travis,45013,Beaufort,SC,Savannah,25,1820000,72800.0,42,2739000,65214.28571428572,-17,-919000
2021,county,48029,Bexar,48025,Bee,TX,Rural Texas,152,3030000,19934.21052631579,121,1741000,14388.429752066115,31,1289000
2021,county,48491,Williamson,48027,Bell,TX,Rural Texas,1822,86494000,47472.008781558725,2539,86368000,34016.54194564789,-717,126000
2021,county,48453,Travis,48027,Bell,TX,Rural Texas,1187,30206000,25447.346251053074,1774,50356000,28385.569334836528,-587,-20150000
2021,county,48209,Hays,48027,Bell,TX,Rural Texas,158,4476000,28329.113924050635,208,5776000,27769.23076923077,-50,-1300000
2021,county,48091,Comal,48027,Bell,TX,Rural Texas,105,4579000,43609.52380952381,52,2134000,41038.46153846154,53,2445000
2021,county,48029,Bexar,48027,Bell,TX,Rural Texas,987,21457000,21739.614994934145,875,19611000,22412.571428571428,112,1846000
2021,county,48453,Travis,05007,Benton,AR,Rural Arkansas,55,3832000,69672.72727272728,106,5312000,50113.20754716981,-51,-1480000
2021,county,48029,Bexar,05007,Benton,AR,Rural Arkansas,46,1526000,33173.913043478264,76,3735000,49144.73684210526,-30,-2209000
2021,county,48453,Travis,34003,Bergen,NJ,New York,121,9077000,75016.52892561983,53,2646000,49924.52830188679,68,6431000
2021,county,48029,Bexar,45015,Berkeley,SC,Charleston,69,2353000,34101.44927536232,54,1992000,36888.88888888889,15,361000
2021,county,48491,Williamson,35001,Bernalillo,NM,Albuquerque,94,3862000,41085.10638297872,46,1579000,34326.086956521736,48,2283000
2021,county,48453,Travis,35001,Bernalillo,NM,Albuquerque,165,6309000,38236.36363636364,156,9339000,59865.38461538462,9,-3030000
2021,county,48029,Bexar,35001,Bernalillo,NM,Albuquerque,267,9105000,34101.12359550562,175,5017000,28668.571428571428,92,4088000
2021,county,48491,Williamson,48029,Bexar,TX,San Antonio,939,33186000,35341.85303514377,1104,39302000,35599.637681159424,-165,-6116000
2021,county,48453,Travis,48029,Bexar,TX,San Antonio,2314,106925000,46207.86516853933,2765,130012000,47020.614828209764,-451,-23087000
2021,county,48209,Hays,48029,Bexar,TX,San Antonio,869,33121000,38113.92405063291,796,27134000,34087.93969849246,73,5987000
2021,county,48091,Comal,48029,Bexar,TX,San Antonio,5084,216677000,42619.39417781275,2316,93091000,40194.7322970639,2768,123586000
2021,county,48453,Travis,48031,Blanco,TX,Rural Texas,62,6325000,102016.12903225806,215,15457000,71893.02325581395,-153,-9132000
2021,county,48209,Hays,48031,Blanco,TX,Rural Texas,50,2166000,43320.0,196,9724000,49612.244897959186,-146,-7558000
2021,county,48091,Comal,48031,Blanco,TX,Rural Texas,94,4177000,44436.17021276596,145,4849000,33441.379310344826,-51,-672000
2021,county,48029,Bexar,48031,Blanco,TX,Rural Texas,52,1455000,27980.76923076923,113,5035000,44557.5221238938,-61,-3580000
2021,county,48029,Bexar,22015,Bossier Parish,LA,Rural Louisiana,155,3978000,25664.516129032258,95,2766000,29115.78947368421,60,1212000
2021,county,48491,Williamson,08013,Boulder,CO,Denver,43,1686000,39209.3023255814,40,1605000,40125.0,3,81000
2021,county,48453,Travis,08013,Boulder,CO,Denver,111,6335000,57072.07207207207,201,14136000,70328.35820895522,-90,-7801000
2021,county,48029,Bexar,08013,Boulder,CO,Denver,48,1440000,30000.0,57,3052000,53543.85964912281,-9,-1612000
2021,county,48453,Travis,48037,Bowie,TX,Rural Texas,31,620000,20000.0,33,1077000,32636.363636363636,-2,-457000
2021,county,48491,Williamson,48039,Brazoria,TX,Houston,117,5060000,43247.86324786325,111,4755000,42837.83783783784,6,305000
2021,county,48453,Travis,48039,Brazoria,TX,Houston,223,8669000,38874.439461883405,236,10455000,44300.84745762712,-13,-1786000
2021,county,48209,Hays,48039,Brazoria,TX,Houston,75,3723000,49640.0,66,2083000,31560.60606060606,9,1640000
2021,county,48091,Comal,48039,Brazoria,TX,Houston,76,5022000,66078.94736842105,32,1352000,42250.0,44,3670000
2021,county,48029,Bexar,48039,Brazoria,TX,Houston,225,5215000,23177.777777777777,253,8459000,33434.782608695656,-28,-3244000
2021,county,48491,Williamson,48041,Brazos,TX,Rural Texas,268,10477000,39093.28358208955,314,13479000,42926.75159235669,-46,-3002000
2021,county,48453,Travis,48041,Brazos,TX,Rural Texas,534,19424000,36374.53183520599,390,23867000,61197.4358974359,144,-4443000
2021,county,48209,Hays,48041,Brazos,TX,Rural Texas,56,2214000,39535.71428571428,99,2687000,27141.41414141414,-43,-473000
2021,county,48091,Comal,48041,Brazos,TX,Rural Texas,101,3331000,32980.19801980198,37,2219000,59972.97297297297,64,1112000
2021,county,48029,Bexar,48041,Brazos,TX,Rural Texas,307,9794000,31902.28013029316,239,8562000,35824.26778242678,68,1232000
2021,county,48491,Williamson,12009,Brevard,FL,Atlantic Coast,53,2859000,53943.3962264151,40,2619000,65475.0,13,240000
2021,county,48453,Travis,12009,Brevard,FL,Atlantic Coast,40,2165000,54125.0,100,4121000,41210.0,-60,-1956000
2021,county,48029,Bexar,12009,Brevard,FL,Atlantic Coast,91,3136000,34461.53846153846,127,4013000,31598.425196850392,-36,-877000
2021,county,48029,Bexar,36005,Bronx,NY,New York,79,1794000,22708.86075949367,39,1155000,29615.384615384617,40,639000
2021,county,48453,Travis,08014,Broomfield,CO,Denver,37,2782000,75189.18918918919,44,3884000,88272.72727272728,-7,-1102000
2021,county,48491,Williamson,12011,Broward,FL,Miami,146,4822000,33027.397260273974,57,2223000,39000.0,89,2599000
2021,county,48453,Travis,12011,Broward,FL,Miami,264,14013000,53079.545454545456,135,9963000,73800.0,129,4050000
2021,county,48029,Bexar,12011,Broward,FL,Miami,232,7664000,33034.48275862069,109,5653000,51862.38532110092,123,2011000
2021,county,48491,Williamson,48049,Brown,TX,Rural Texas,41,1130000,27560.975609756097,58,2603000,44879.31034482759,-17,-1473000
2021,county,48453,Travis,48049,Brown,TX,Rural Texas,33,1251000,37909.09090909091,71,1964000,27661.971830985916,-38,-713000
2021,county,48453,Travis,42017,Bucks,PA,Philadelphia,52,4280000,82307.69230769231,23,1507000,65521.739130434784,29,2773000
2021,county,48453,Travis,37021,Buncombe,NC,Asheville,41,899000,21926.829268292684,120,7846000,65383.333333333336,-79,-6947000
2021,county,48029,Bexar,34005,Burlington,NJ,Philadelphia,97,2891000,29804.123711340206,101,2140000,21188.118811881188,-4,751000
2021,county,48491,Williamson,48053,Burnet,TX,Rural Texas,439,15739000,35851.93621867881,1144,65203000,56995.62937062937,-705,-49464000
2021,county,48453,Travis,48053,Burnet,TX,Rural Texas,391,16027000,40989.769820971866,855,55179000,64536.84210526316,-464,-39152000
2021,county,48209,Hays,48053,Burnet,TX,Rural Texas,36,1190000,33055.555555555555,105,5045000,48047.619047619046,-69,-3855000
2021,county,48091,Comal,48053,Burnet,TX,Rural Texas,47,2347000,49936.17021276596,42,1252000,29809.52380952381,5,1095000
2021,county,48029,Bexar,48053,Burnet,TX,Rural Texas,95,3413000,35926.31578947369,129,8288000,64248.06201550388,-34,-4875000
2021,county,48453,Travis,22017,Caddo Parish,LA,Rural Louisiana,71,2417000,34042.25352112676,39,1100000,28205.128205128207,32,1317000
2021,county,48029,Bexar,22017,Caddo Parish,LA,Rural Louisiana,76,2172000,28578.947368421053,56,943000,16839.285714285714,20,1229000
2021,county,48491,Williamson,48055,Caldwell,TX,Rural Texas,79,2131000,26974.683544303796,95,3621000,38115.78947368421,-16,-1490000
2021,county,48453,Travis,48055,Caldwell,TX,Rural Texas,410,6840000,16682.926829268294,1196,28501000,23830.267558528427,-786,-21661000
2021,county,48209,Hays,48055,Caldwell,TX,Rural Texas,658,17018000,25863.22188449848,732,15728000,21486.33879781421,-74,1290000
2021,county,48091,Comal,48055,Caldwell,TX,Rural Texas,81,2347000,28975.30864197531,44,1116000,25363.636363636364,37,1231000
2021,county,48029,Bexar,48055,Caldwell,TX,Rural Texas,101,1988000,19683.168316831685,114,2548000,22350.877192982458,-13,-560000
2021,county,48491,Williamson,48061,Cameron,TX,Rural Texas,93,2710000,29139.78494623656,110,3485000,31681.81818181818,-17,-775000
2021,county,48453,Travis,48061,Cameron,TX,Rural Texas,287,10858000,37832.75261324042,286,10985000,38409.09090909091,1,-127000
2021,county,48209,Hays,48061,Cameron,TX,Rural Texas,101,2304000,22811.881188118812,51,1164000,22823.529411764706,50,1140000
2021,county,48029,Bexar,48061,Cameron,TX,Rural Texas,914,23339000,25535.010940919037,732,15997000,21853.82513661202,182,7342000
2021,county,48029,Bexar,30013,Cascade,MT,Rural Montana,89,1989000,22348.314606741573,106,2680000,25283.01886792453,-17,-691000
2021,county,48453,Travis,45019,Charleston,SC,Charleston,66,4299000,65136.36363636364,59,3345000,56694.91525423729,7,954000
2021,county,48029,Bexar,45019,Charleston,SC,Charleston,67,3044000,45432.835820895525,92,3455000,37554.34782608696,-25,-411000
2021,county,48029,Bexar,13051,Chatham,GA,Savannah,72,1718000,23861.11111111111,46,1713000,37239.13043478261,26,5000
2021,county,48029,Bexar,51550,Chesapeake city,VA,Hampton Roads,62,2044000,32967.74193548387,61,1770000,29016.39344262295,1,274000
2021,county,48029,Bexar,51041,Chesterfield,VA,Richmond,58,2061000,35534.48275862069,74,1993000,26932.432432432433,-16,68000
2021,county,48453,Travis,41005,Clackamas,OR,Portland,51,2658000,52117.64705882353,35,2398000,68514.28571428571,16,260000
2021,county,48491,Williamson,32003,Clark,NV,Las Vegas,243,9406000,38707.818930041154,143,5866000,41020.97902097902,100,3540000
2021,county,48453,Travis,32003,Clark,NV,Las Vegas,385,36958000,95994.8051948052,238,9571000,40214.28571428572,147,27387000
2021,county,48453,Travis,53011,Clark,WA,Portland,48,2625000,54687.5,79,4879000,61759.49367088608,-31,-2254000
2021,county,48091,Comal,32003,Clark,NV,Las Vegas,103,5190000,50388.34951456311,33,1231000,37303.030303030304,70,3959000
2021,county,48029,Bexar,32003,Clark,NV,Las Vegas,834,24627000,29528.776978417267,619,19537000,31562.197092084007,215,5090000
2021,county,48029,Bexar,53011,Clark,WA,Portland,128,4125000,32226.5625,52,1610000,30961.53846153846,76,2515000
2021,county,48029,Bexar,12019,Clay,FL,Jacksonville,55,1441000,26200.0,73,1996000,27342.465753424658,-18,-555000
2021,county,48453,Travis,40027,Cleveland,OK,Oklahoma City,35,2271000,64885.71428571428,58,1548000,26689.655172413793,-23,723000
2021,county,48029,Bexar,40027,Cleveland,OK,Oklahoma City,70,2186000,31228.571428571428,80,2258000,28225.0,-10,-72000
2021,county,48453,Travis,13067,Cobb,GA,Atlanta,103,6964000,67611.6504854369,136,6156000,45264.705882352944,-33,808000
2021,county,48029,Bexar,13067,Cobb,GA,Atlanta,75,2347000,31293.333333333332,67,2769000,41328.35820895522,8,-422000
2021,county,48029,Bexar,04003,Cochise,AZ,Rural Arizona,87,2726000,31333.333333333332,87,1793000,20609.19540229885,0,933000
2021,county,48453,Travis,12021,Collier,FL,S.W. Florida,75,4932000,65760.0,43,6638000,154372.09302325582,32,-1706000
2021,county,48491,Williamson,48085,Collin,TX,Dallas-Fort Worth,500,31437000,62874.0,565,26014000,46042.4778761062,-65,5423000
2021,county,48453,Travis,48085,Collin,TX,Dallas-Fort Worth,924,56024000,60632.03463203463,961,47092000,49003.12174817898,-37,8932000
2021,county,48209,Hays,48085,Collin,TX,Dallas-Fort Worth,142,8522000,60014.08450704225,135,4488000,33244.444444444445,7,4034000
2021,county,48091,Comal,48085,Collin,TX,Dallas-Fort Worth,97,6493000,66938.14432989691,57,2391000,41947.36842105263,40,4102000
2021,county,48029,Bexar,48085,Collin,TX,Dallas-Fort Worth,587,41525000,70741.05621805791,816,34886000,42752.450980392154,-229,6639000
2021,county,48029,Bexar,13073,Columbia,GA,Augusta,134,4468000,33343.28358208955,112,3073000,27437.5,22,1395000
2021,county,48491,Williamson,48091,Comal,TX,San Antonio,184,7282000,39576.086956521736,332,17657000,53183.73493975904,-148,-10375000
2021,county,48453,Travis,48091,Comal,TX,San Antonio,388,18398000,47417.52577319588,934,53343000,57112.41970021413,-546,-34945000
2021,county,48209,Hays,48091,Comal,TX,San Antonio,622,20421000,32831.18971061093,1259,42806000,34000.0,-637,-22385000
2021,county,48029,Bexar,48091,Comal,TX,San Antonio,2316,93091000,40194.7322970639,5084,216677000,42619.39417781275,-2768,-123586000
2021,county,48029,Bexar,40031,Comanche,OK,Rural Oklahoma,135,3380000,25037.037037037036,48,1192000,24833.333333333332,87,2188000
2021,county,48453,Travis,06013,Contra Costa,CA,Bay Area,399,57663000,144518.7969924812,86,11152000,129674.41860465116,313,46511000
2021,county,48029,Bexar,06013,Contra Costa,CA,Bay Area,173,11834000,68404.62427745665,42,2518000,59952.380952380954,131,9316000
2021,county,48491,Williamson,17031,Cook,IL,Chicago,471,29647000,62944.7983014862,102,3680000,36078.43137254902,369,25967000
2021,county,48453,Travis,17031,Cook,IL,Chicago,1469,243081000,165473.79169503064,516,31864000,61751.93798449612,953,211217000
2021,county,48209,Hays,17031,Cook,IL,Chicago,96,5093000,53052.083333333336,41,1842000,44926.829268292684,55,3251000
2021,county,48029,Bexar,17031,Cook,IL,Chicago,594,22197000,37368.68686868687,302,10594000,35079.470198675495,292,11603000
2021,county,48491,Williamson,48099,Coryell,TX,Rural Texas,157,4077000,25968.15286624204,231,7666000,33186.14718614719,-74,-3589000
2021,county,48453,Travis,48099,Coryell,TX,Rural Texas,115,2831000,24617.391304347828,170,4694000,27611.764705882353,-55,-1863000
2021,county,48029,Bexar,48099,Coryell,TX,Rural Texas,201,4057000,20184.079601990048,188,3046000,16202.127659574468,13,1011000
2021,county,48453,Travis,23005,Cumberland,ME,Portland,42,1711000,40738.09523809524,58,3189000,54982.75862068965,-16,-1478000
2021,county,48453,Travis,37051,Cumberland,NC,Rural North Carolina,40,1016000,25400.0,39,1233000,31615.384615384617,1,-217000
2021,county,48029,Bexar,37051,Cumberland,NC,Rural North Carolina,327,7159000,21892.96636085627,203,5672000,27940.886699507388,124,1487000
2021,county,48029,Bexar,35009,Curry,NM,Rural New Mexico,117,3275000,27991.452991452992,85,2002000,23552.941176470587,32,1273000
2021,county,48453,Travis,39035,Cuyahoga,OH,Cleveland,101,8319000,82366.33663366336,83,3775000,45481.927710843374,18,4544000
2021,county,48029,Bexar,39035,Cuyahoga,OH,Cleveland,99,4212000,42545.454545454544,64,3251000,50796.875,35,961000
2021,county,48491,Williamson,48113,Dallas,TX,Dallas-Fort Worth,703,37900000,53911.80654338549,581,29242000,50330.464716006885,122,8658000
2021,county,48453,Travis,48113,Dallas,TX,Dallas-Fort Worth,2200,155555000,70706.81818181818,1913,113497000,59329.32566649242,287,42058000
2021,county,48209,Hays,48113,Dallas,TX,Dallas-Fort Worth,214,12029000,56210.280373831774,204,6635000,32524.50980392157,10,5394000
2021,county,48091,Comal,48113,Dallas,TX,Dallas-Fort Worth,144,6105000,42395.833333333336,98,4457000,45479.5918367347,46,1648000
2021,county,48029,Bexar,48113,Dallas,TX,Dallas-Fort Worth,1224,50917000,41598.856209150326,1382,54071000,39125.180897250364,-158,-3154000
2021,county,48453,Travis,55025,Dane,WI,Madison,149,9506000,63798.657718120805,75,3211000,42813.333333333336,74,6295000
2021,county,48029,Bexar,55025,Dane,WI,Madison,51,1647000,32294.117647058825,45,1960000,43555.555555555555,6,-313000
2021,county,48491,Williamson,47037,Davidson,TN,Nashville,66,2877000,43590.90909090909,42,1961000,46690.47619047619,24,916000
2021,county,48453,Travis,47037,Davidson,TN,Nashville,168,11276000,67119.04761904762,184,14975000,81385.86956521739,-16,-3699000
2021,county,48029,Bexar,47037,Davidson,TN,Nashville,97,4308000,44412.37113402062,132,5089000,38553.030303030304,-35,-781000
2021,county,48029,Bexar,49011,Davis,UT,Rural Utah,151,3573000,23662.251655629138,119,3317000,27873.949579831933,32,256000
2021,county,48453,Travis,13089,DeKalb,GA,Atlanta,92,4648000,50521.739130434784,123,7841000,63747.96747967479,-31,-3193000
2021,county,48029,Bexar,13089,DeKalb,GA,Atlanta,45,1478000,32844.444444444445,69,1980000,28695.652173913044,-24,-502000
2021,county,48029,Bexar,48123,DeWitt,TX,Rural Texas,44,1837000,41750.0,50,979000,19580.0,-6,858000
2021,county,48491,Williamson,48121,Denton,TX,Dallas-Fort Worth,412,18417000,44701.45631067961,422,20431000,48414.69194312796,-10,-2014000
2021,county,48453,Travis,48121,Denton,TX,Dallas-Fort Worth,627,36202000,57738.437001594895,641,33867000,52834.633385335415,-14,2335000
2021,county,48209,Hays,48121,Denton,TX,Dallas-Fort Worth,110,5424000,49309.09090909091,119,5407000,45436.97478991596,-9,17000
2021,county,48091,Comal,48121,Denton,TX,Dallas-Fort Worth,115,7952000,69147.82608695653,82,4522000,55146.34146341463,33,3430000
2021,county,48029,Bexar,48121,Denton,TX,Dallas-Fort Worth,516,19014000,36848.83720930233,661,29314000,44347.95763993949,-145,-10300000
2021,county,48491,Williamson,08031,Denver,CO,Denver,89,5486000,61640.449438202246,62,2781000,44854.83870967742,27,2705000
2021,county,48453,Travis,08031,Denver,CO,Denver,370,42883000,115900.0,506,35082000,69332.01581027667,-136,7801000
2021,county,48029,Bexar,08031,Denver,CO,Denver,200,9123000,45615.0,207,7976000,38531.40096618357,-7,1147000
2021,county,48453,Travis,41017,Deschutes,OR,Rural Oregon,46,2557000,55586.95652173913,56,5153000,92017.85714285714,-10,-2596000
2021,county,48029,Bexar,48127,Dimmit,TX,Rural Texas,48,1221000,25437.5,76,1326000,17447.36842105263,-28,-105000
2021,county,48453,Travis,11001,District of Columbia,DC,D.C.,351,38548000,109823.36182336182,192,12892000,67145.83333333333,159,25656000
2021,county,48029,Bexar,11001,District of Columbia,DC,D.C.,119,8779000,73773.10924369747,115,5946000,51704.34782608696,4,2833000
2021,county,48453,Travis,35013,Dona Ana,NM,Rural New Mexico,73,2463000,33739.72602739726,44,1498000,34045.454545454544,29,965000
2021,county,48029,Bexar,35013,Dona Ana,NM,Rural New Mexico,87,2684000,30850.57471264368,43,1605000,37325.58139534884,44,1079000
2021,county,48491,Williamson,08035,Douglas,CO,Denver,89,6001000,67426.96629213484,57,2613000,45842.10526315789,32,3388000
2021,county,48453,Travis,08035,Douglas,CO,Denver,104,6412000,61653.846153846156,156,8952000,57384.61538461538,-52,-2540000
2021,county,48453,Travis,31055,Douglas,NE,Omaha,81,3321000,41000.0,54,2454000,45444.444444444445,27,867000
2021,county,48029,Bexar,08035,Douglas,CO,Denver,130,9866000,75892.30769230769,99,4643000,46898.9898989899,31,5223000
2021,county,48029,Bexar,31055,Douglas,NE,Omaha,85,3248000,38211.76470588235,86,1989000,23127.906976744187,-1,1259000
2021,county,48453,Travis,17043,DuPage,IL,Chicago,172,12626000,73406.97674418605,86,4110000,47790.6976744186,86,8516000
2021,county,48029,Bexar,17043,DuPage,IL,Chicago,131,4544000,34687.02290076336,46,1584000,34434.782608695656,85,2960000
2021,county,48453,Travis,37063,Durham,NC,Raleigh,88,4949000,56238.63636363636,65,2884000,44369.230769230766,23,2065000
2021,county,48453,Travis,12031,Duval,FL,Jacksonville,79,4259000,53911.39240506329,109,4974000,45633.02752293578,-30,-715000
2021,county,48029,Bexar,12031,Duval,FL,Jacksonville,144,4061000,28201.38888888889,198,6932000,35010.10101010101,-54,-2871000
2021,county,48453,Travis,22033,East Baton Rouge Parish,LA,Rural Louisiana,147,6335000,43095.23809523809,86,3862000,44906.976744186046,61,2473000
2021,county,48029,Bexar,22033,East Baton Rouge Parish,LA,Rural Louisiana,97,2534000,26123.711340206184,45,1570000,34888.88888888889,52,964000
2021,county,48453,Travis,48135,Ector,TX,Rural Texas,171,5256000,30736.842105263157,47,1262000,26851.063829787236,124,3994000
2021,county,48029,Bexar,48135,Ector,TX,Rural Texas,341,8715000,25557.184750733137,126,2921000,23182.539682539682,215,5794000
2021,county,48491,Williamson,48141,El Paso,TX,El Paso,309,10852000,35119.74110032363,160,5903000,36893.75,149,4949000
2021,county,48491,Williamson,08041,El Paso,CO,Colorado Springs,163,5664000,34748.46625766871,186,7129000,38327.95698924731,-23,-1465000
2021,county,48453,Travis,48141,El Paso,TX,El Paso,503,16761000,33322.0675944334,364,14228000,39087.91208791209,139,2533000
2021,county,48453,Travis,08041,El Paso,CO,Colorado Springs,182,7867000,43225.27472527473,236,10774000,45652.542372881355,-54,-2907000
2021,county,48209,Hays,48141,El Paso,TX,El Paso,86,3044000,35395.348837209305,56,1342000,23964.285714285714,30,1702000
2021,county,48209,Hays,08041,El Paso,CO,Colorado Springs,54,2368000,43851.851851851854,56,2069000,36946.42857142857,-2,299000
2021,county,48091,Comal,08041,El Paso,CO,Colorado Springs,102,4219000,41362.74509803922,73,3136000,42958.90410958904,29,1083000
2021,county,48029,Bexar,48141,El Paso,TX,El Paso,1493,41871000,28044.87608841259,983,25359000,25797.558494404882,510,16512000
2021,county,48029,Bexar,08041,El Paso,CO,Colorado Springs,888,24179000,27228.603603603602,852,24771000,29073.943661971833,36,-592000
2021,county,48491,Williamson,48139,Ellis,TX,Dallas-Fort Worth,75,2801000,37346.666666666664,76,2186000,28763.157894736843,-1,615000
2021,county,48453,Travis,48139,Ellis,TX,Dallas-Fort Worth,83,2932000,35325.301204819276,86,3413000,39686.04651162791,-3,-481000
2021,county,48029,Bexar,48139,Ellis,TX,Dallas-Fort Worth,91,3053000,33549.45054945055,131,3111000,23748.091603053435,-40,-58000
2021,county,48453,Travis,12033,Escambia,FL,FL Panhandle,45,1432000,31822.222222222223,27,928000,34370.37037037037,18,504000
2021,county,48029,Bexar,12033,Escambia,FL,FL Panhandle,127,3077000,24228.346456692914,137,3388000,24729.92700729927,-10,-311000
2021,county,48453,Travis,25009,Essex,MA,Boston,78,6029000,77294.8717948718,43,2470000,57441.86046511628,35,3559000
2021,county,48029,Bexar,02090,Fairbanks North Star Borough,AK,Rural Alaska,115,2860000,24869.565217391304,91,2613000,28714.285714285714,24,247000
2021,county,48491,Williamson,51059,Fairfax,VA,D.C.,171,8895000,52017.54385964912,65,3302000,50800.0,106,5593000
2021,county,48453,Travis,51059,Fairfax,VA,D.C.,262,23047000,87965.64885496184,101,7887000,78089.10891089108,161,15160000
2021,county,48029,Bexar,51059,Fairfax,VA,D.C.,502,25038000,49876.49402390438,416,17991000,43247.596153846156,86,7047000
2021,county,48453,Travis,09001,Fairfield,CT,New York,172,22260000,129418.6046511628,98,10476000,106897.95918367348,74,11784000
2021,county,48453,Travis,21067,Fayette,KY,Lexington,52,1586000,30500.0,43,1913000,44488.37209302326,9,-327000
2021,county,48453,Travis,48149,Fayette,TX,Rural Texas,36,1930000,53611.11111111111,125,5196000,41568.0,-89,-3266000
2021,county,48029,Bexar,21067,Fayette,KY,Lexington,63,1978000,31396.825396825396,53,1719000,32433.962264150945,10,259000
2021,county,48491,Williamson,48157,Fort Bend,TX,Houston,384,16184000,42145.833333333336,343,10922000,31842.56559766764,41,5262000
2021,county,48453,Travis,48157,Fort Bend,TX,Houston,634,36889000,58184.54258675079,731,39879000,54554.03556771546,-97,-2990000
2021,county,48209,Hays,48157,Fort Bend,TX,Houston,162,7559000,46660.49382716049,74,2054000,27756.756756756757,88,5505000
2021,county,48091,Comal,48157,Fort Bend,TX,Houston,187,20439000,109299.46524064172,53,3619000,68283.01886792453,134,16820000
2021,county,48029,Bexar,48157,Fort Bend,TX,Houston,491,20462000,41674.134419551934,667,23256000,34866.56671664168,-176,-2794000
2021,county,48453,Travis,39049,Franklin,OH,Columbus,184,10230000,55597.82608695652,104,4602000,44250.0,80,5628000
2021,county,48029,Bexar,39049,Franklin,OH,Columbus,165,5645000,34212.121212121216,115,4549000,39556.52173913043,50,1096000
2021,county,48029,Bexar,24021,Frederick,MD,Rural Maryland,79,2553000,32316.45569620253,50,1970000,39400.0,29,583000
2021,county,48453,Travis,06019,Fresno,CA,Fresno,52,1675000,32211.53846153846,57,1726000,30280.701754385966,-5,-51000
2021,county,48029,Bexar,06019,Fresno,CA,Fresno,112,3808000,34000.0,46,1079000,23456.521739130436,66,2729000
2021,county,48029,Bexar,48163,Frio,TX,Rural Texas,187,5871000,31395.72192513369,285,5268000,18484.21052631579,-98,603000
2021,county,48491,Williamson,13121,Fulton,GA,Atlanta,80,6040000,75500.0,32,1718000,53687.5,48,4322000
2021,county,48453,Travis,13121,Fulton,GA,Atlanta,252,21072000,83619.04761904762,233,14820000,63605.15021459227,19,6252000
2021,county,48029,Bexar,13121,Fulton,GA,Atlanta,95,7706000,81115.78947368421,124,4594000,37048.3870967742,-29,3112000
2021,county,48453,Travis,30031,Gallatin,MT,Rural Montana,28,2165000,77321.42857142857,30,3239000,107966.66666666667,-2,-1074000
2021,county,48491,Williamson,48167,Galveston,TX,Houston,154,5976000,38805.194805194806,114,4786000,41982.45614035088,40,1190000
2021,county,48453,Travis,48167,Galveston,TX,Houston,226,15511000,68632.74336283185,281,13264000,47202.84697508897,-55,2247000
2021,county,48209,Hays,48167,Galveston,TX,Houston,78,3345000,42884.61538461538,62,3241000,52274.1935483871,16,104000
2021,county,48091,Comal,48167,Galveston,TX,Houston,107,7377000,68943.92523364486,41,2787000,67975.60975609756,66,4590000
2021,county,48029,Bexar,48167,Galveston,TX,Houston,269,9620000,35762.08178438662,227,9059000,39907.48898678414,42,561000
2021,county,48029,Bexar,20061,Geary,KS,Rural Kansas,142,3112000,21915.49295774648,72,1311000,18208.333333333332,70,1801000
2021,county,48491,Williamson,48171,Gillespie,TX,Rural Texas,29,454000,15655.172413793103,36,1502000,41722.22222222222,-7,-1048000
2021,county,48453,Travis,48171,Gillespie,TX,Rural Texas,51,459000,9000.0,166,18864000,113638.55421686747,-115,-18405000
2021,county,48029,Bexar,48171,Gillespie,TX,Rural Texas,143,5745000,40174.82517482517,156,7964000,51051.282051282054,-13,-2219000
2021,county,48209,Hays,48177,Gonzales,TX,Rural Texas,35,807000,23057.14285714286,37,2164000,58486.48648648649,-2,-1357000
2021,county,48029,Bexar,48177,Gonzales,TX,Rural Texas,71,1034000,14563.38028169014,97,3200000,32989.69072164949,-26,-2166000
2021,county,48453,Travis,48181,Grayson,TX,Rural Texas,38,1134000,29842.105263157893,58,3123000,53844.8275862069,-20,-1989000
2021,county,48453,Travis,29077,Greene,MO,Rural Missouri,27,944000,34962.96296296296,35,944000,26971.428571428572,-8,0
2021,county,48029,Bexar,39057,Greene,OH,Rural Ohio,80,3672000,45900.0,125,5262000,42096.0,-45,-1590000
2021,county,48453,Travis,45045,Greenville,SC,Greenville,53,2436000,45962.264150943396,66,2790000,42272.72727272727,-13,-354000
2021,county,48029,Bexar,45045,Greenville,SC,Greenville,46,1751000,38065.217391304344,49,1446000,29510.20408163265,-3,305000
2021,county,48491,Williamson,48183,Gregg,TX,Rural Texas,39,1376000,35282.05128205128,58,1824000,31448.275862068964,-19,-448000
2021,county,48453,Travis,48183,Gregg,TX,Rural Texas,51,2352000,46117.64705882353,63,3624000,57523.80952380953,-12,-1272000
2021,county,48029,Bexar,48183,Gregg,TX,Rural Texas,67,3599000,53716.41791044776,73,2772000,37972.602739726026,-6,827000
2021,county,48491,Williamson,48187,Guadalupe,TX,San Antonio,110,4862000,44200.0,240,7360000,30666.666666666668,-130,-2498000
2021,county,48453,Travis,48187,Guadalupe,TX,San Antonio,243,8467000,34843.621399176955,464,17580000,37887.93103448276,-221,-9113000
2021,county,48209,Hays,48187,Guadalupe,TX,San Antonio,717,15645000,21820.083682008368,1084,27949000,25783.21033210332,-367,-12304000
2021,county,48091,Comal,48187,Guadalupe,TX,San Antonio,2570,99345000,38655.64202334631,2420,69762000,28827.272727272728,150,29583000
2021,county,48029,Bexar,48187,Guadalupe,TX,San Antonio,3826,106937000,27950.078410872975,5092,155622000,30562.05813040063,-1266,-48685000
2021,county,48029,Bexar,37081,Guilford,NC,Greensboro,53,1370000,25849.056603773584,44,2303000,52340.90909090909,9,-933000
2021,county,48453,Travis,13135,Gwinnett,GA,Atlanta,68,3173000,46661.76470588235,65,2529000,38907.692307692305,3,644000
2021,county,48029,Bexar,13135,Gwinnett,GA,Atlanta,69,2078000,30115.942028985508,111,2941000,26495.495495495496,-42,-863000
2021,county,48453,Travis,39061,Hamilton,OH,Cincinnati,81,5159000,63691.358024691355,68,3013000,44308.82352941176,13,2146000
2021,county,48453,Travis,47065,Hamilton,TN,Chattanooga,36,1916000,53222.22222222222,66,3902000,59121.21212121212,-30,-1986000
2021,county,48029,Bexar,39061,Hamilton,OH,Cincinnati,60,1861000,31016.666666666668,48,1556000,32416.666666666668,12,305000
2021,county,48029,Bexar,51650,Hampton city,VA,Hampton Roads,95,2575000,27105.263157894737,76,2442000,32131.57894736842,19,133000
2021,county,48029,Bexar,21093,Hardin,KY,Louisville,51,1565000,30686.274509803923,60,1567000,26116.666666666668,-9,-2000
2021,county,48029,Bexar,24025,Harford,MD,Baltimore,56,1338000,23892.85714285714,42,1257000,29928.571428571428,14,81000
2021,county,48029,Bexar,37085,Harnett,NC,Rural North Carolina,119,2470000,20756.302521008405,66,1598000,24212.121212121212,53,872000
2021,county,48491,Williamson,48201,Harris,TX,Houston,1609,71946000,44714.7296457427,1107,43053000,38891.59891598916,502,28893000
2021,county,48453,Travis,48201,Harris,TX,Houston,4334,283332000,65374.25011536686,3293,161676000,49096.872153051925,1041,121656000
2021,county,48209,Hays,48201,Harris,TX,Houston,635,37550000,59133.85826771653,488,18535000,37981.55737704918,147,19015000
2021,county,48091,Comal,48201,Harris,TX,Houston,757,64966000,85820.34346103038,223,8855000,39708.5201793722,534,56111000
2021,county,48029,Bexar,48201,Harris,TX,Houston,2958,112929000,38177.48478701826,2860,101539000,35503.146853146856,98,11390000
2021,county,48029,Bexar,28047,Harrison,MS,Gulfport-Biloxi,183,4052000,22142.07650273224,105,2997000,28542.85714285714,78,1055000
2021,county,48453,Travis,09003,Hartford,CT,Hartford,81,10119000,124925.92592592593,67,4976000,74268.65671641791,14,5143000
2021,county,48029,Bexar,09003,Hartford,CT,Hartford,66,2902000,43969.69696969697,35,1201000,34314.28571428572,31,1701000
2021,county,48491,Williamson,48209,Hays,TX,Austin,813,28700000,35301.35301353013,979,39310000,40153.217568947905,-166,-10610000
2021,county,48453,Travis,48209,Hays,TX,Austin,3793,168259000,44360.40073820195,9764,526199000,53891.74518639901,-5971,-357940000
2021,county,48091,Comal,48209,Hays,TX,Austin,1259,42806000,34000.0,622,20421000,32831.18971061093,637,22385000
2021,county,48029,Bexar,48209,Hays,TX,Austin,796,27134000,34087.93969849246,869,33121000,38113.92405063291,-73,-5987000
2021,county,48491,Williamson,27053,Hennepin,MN,Minneapolis,174,10823000,62201.14942528736,42,2401000,57166.666666666664,132,8422000
2021,county,48453,Travis,27053,Hennepin,MN,Minneapolis,340,40987000,120550.0,145,9547000,65841.37931034483,195,31440000
2021,county,48029,Bexar,27053,Hennepin,MN,Minneapolis,149,8482000,56926.17449664429,90,4146000,46066.666666666664,59,4336000
2021,county,48453,Travis,51087,Henrico,VA,Richmond,37,2440000,65945.94594594595,45,1834000,40755.555555555555,-8,606000
2021,county,48491,Williamson,48215,Hidalgo,TX,Rural Texas,213,6839000,32107.98122065728,160,3933000,24581.25,53,2906000
2021,county,48453,Travis,48215,Hidalgo,TX,Rural Texas,461,12875000,27928.416485900216,479,15977000,33354.90605427975,-18,-3102000
2021,county,48209,Hays,48215,Hidalgo,TX,Rural Texas,103,2919000,28339.805825242718,99,2086000,21070.70707070707,4,833000
2021,county,48091,Comal,48215,Hidalgo,TX,Rural Texas,118,3420000,28983.050847457627,45,1177000,26155.555555555555,73,2243000
2021,county,48029,Bexar,48215,Hidalgo,TX,Rural Texas,1406,38609000,27460.170697012803,999,24833000,24857.857857857856,407,13776000
2021,county,48491,Williamson,12057,Hillsborough,FL,Tampa,95,3605000,37947.36842105263,109,3488000,32000.0,-14,117000
2021,county,48453,Travis,12057,Hillsborough,FL,Tampa,194,8580000,44226.80412371134,210,12651000,60242.857142857145,-16,-4071000
2021,county,48453,Travis,33011,Hillsborough,NH,Rural New Hampshire,58,3344000,57655.1724137931,34,1350000,39705.882352941175,24,1994000
2021,county,48029,Bexar,12057,Hillsborough,FL,Tampa,302,9769000,32347.6821192053,306,14931000,48794.117647058825,-4,-5162000
2021,county,48491,Williamson,15003,Honolulu,HI,Rural Hawaii,106,3241000,30575.471698113208,86,3351000,38965.11627906977,20,-110000
2021,county,48453,Travis,15003,Honolulu,HI,Rural Hawaii,143,6575000,45979.02097902098,105,3693000,35171.42857142857,38,2882000
2021,county,48029,Bexar,15003,Honolulu,HI,Rural Hawaii,863,31650000,36674.39165701043,564,13742000,24365.248226950356,299,17908000
2021,county,48029,Bexar,13153,Houston,GA,Rural Georgia,96,2966000,30895.833333333332,106,2719000,25650.943396226416,-10,247000
2021,county,48029,Bexar,24027,Howard,MD,Baltimore,99,4639000,46858.58585858586,73,3698000,50657.53424657534,26,941000
2021,county,48453,Travis,34017,Hudson,NJ,New York,275,44460000,161672.72727272726,84,5758000,68547.61904761905,191,38702000
2021,county,48453,Travis,29095,Jackson,MO,Kansas City,99,6606000,66727.27272727272,106,4922000,46433.96226415094,-7,1684000
2021,county,48029,Bexar,29095,Jackson,MO,Kansas City,94,3253000,34606.382978723406,83,2966000,35734.93975903615,11,287000
2021,county,48029,Bexar,28059,Jackson,MS,Gulfport-Biloxi,64,1565000,24453.125,64,1331000,20796.875,0,234000
2021,county,48491,Williamson,48245,Jefferson,TX,Rural Texas,95,2738000,28821.052631578947,52,1495000,28750.0,43,1243000
2021,county,48491,Williamson,08059,Jefferson,CO,Denver,68,4572000,67235.29411764706,42,2424000,57714.28571428572,26,2148000
2021,county,48453,Travis,48245,Jefferson,TX,Rural Texas,172,6489000,37726.74418604651,104,2760000,26538.46153846154,68,3729000
2021,county,48453,Travis,08059,Jefferson,CO,Denver,155,10458000,67470.96774193548,211,13452000,63753.55450236967,-56,-2994000
2021,county,48453,Travis,21111,Jefferson,KY,Louisville,99,4826000,48747.47474747475,78,3788000,48564.10256410256,21,1038000
2021,county,48453,Travis,01073,Jefferson,AL,Birmingham,60,3493000,58216.666666666664,57,2936000,51508.771929824565,3,557000
2021,county,48029,Bexar,48245,Jefferson,TX,Rural Texas,182,5817000,31961.53846153846,113,3280000,29026.548672566372,69,2537000
2021,county,48029,Bexar,36045,Jefferson,NY,Rural New York,144,2665000,18506.944444444445,74,2247000,30364.864864864863,70,418000
2021,county,48029,Bexar,08059,Jefferson,CO,Denver,97,4177000,43061.85567010309,102,3681000,36088.23529411765,-5,496000
2021,county,48029,Bexar,21111,Jefferson,KY,Louisville,90,2905000,32277.777777777777,59,1863000,31576.271186440677,31,1042000
2021,county,48453,Travis,22051,Jefferson Parish,LA,New Orleans,79,3222000,40784.81012658228,58,1089000,18775.862068965518,21,2133000
2021,county,48029,Bexar,22051,Jefferson Parish,LA,New Orleans,106,2863000,27009.43396226415,49,934000,19061.224489795917,57,1929000
2021,county,48029,Bexar,48249,Jim Wells,TX,Rural Texas,172,2289000,13308.139534883721,127,2610000,20551.181102362203,45,-321000
2021,county,48491,Williamson,48251,Johnson,TX,Dallas-Fort Worth,43,1143000,26581.39534883721,87,2829000,32517.241379310344,-44,-1686000
2021,county,48453,Travis,20091,Johnson,KS,Kansas City,154,11642000,75597.4025974026,85,6791000,79894.11764705883,69,4851000
2021,county,48453,Travis,48251,Johnson,TX,Dallas-Fort Worth,54,1403000,25981.48148148148,60,3416000,56933.333333333336,-6,-2013000
2021,county,48029,Bexar,20091,Johnson,KS,Kansas City,134,6931000,51723.880597014926,69,2955000,42826.086956521736,65,3976000
2021,county,48029,Bexar,48251,Johnson,TX,Dallas-Fort Worth,48,983000,20479.166666666668,94,2229000,23712.76595744681,-46,-1246000
2021,county,48029,Bexar,48255,Karnes,TX,Rural Texas,82,3459000,42182.92682926829,117,2087000,17837.606837606836,-35,1372000
2021,county,48453,Travis,48257,Kaufman,TX,Dallas-Fort Worth,50,1602000,32040.0,70,2120000,30285.714285714286,-20,-518000
2021,county,48029,Bexar,48257,Kaufman,TX,Dallas-Fort Worth,57,1333000,23385.964912280702,91,2908000,31956.043956043955,-34,-1575000
2021,county,48491,Williamson,48259,Kendall,TX,Rural Texas,34,945000,27794.117647058825,42,1681000,40023.80952380953,-8,-736000
2021,county,48453,Travis,48259,Kendall,TX,Rural Texas,58,2596000,44758.620689655174,138,7588000,54985.50724637681,-80,-4992000
2021,county,48091,Comal,48259,Kendall,TX,Rural Texas,164,6566000,40036.58536585366,168,9956000,59261.90476190476,-4,-3390000
2021,county,48029,Bexar,48259,Kendall,TX,Rural Texas,1035,54381000,52542.02898550725,2084,120126000,57642.034548944335,-1049,-65745000
2021,county,48453,Travis,26081,Kent,MI,Rural Michigan,60,3710000,61833.333333333336,62,2434000,39258.06451612903,-2,1276000
2021,county,48029,Bexar,10001,Kent,DE,Rural Delaware,81,1949000,24061.728395061727,76,1734000,22815.78947368421,5,215000
2021,county,48029,Bexar,26081,Kent,MI,Rural Michigan,56,2568000,45857.142857142855,59,1839000,31169.491525423728,-3,729000
2021,county,48453,Travis,06029,Kern,CA,Rural California,37,1467000,39648.64864864865,44,1283000,29159.090909090908,-7,184000
2021,county,48029,Bexar,06029,Kern,CA,Rural California,186,5697000,30629.032258064515,95,1517000,15968.421052631578,91,4180000
2021,county,48453,Travis,48265,Kerr,TX,Rural Texas,75,2903000,38706.666666666664,136,7843000,57669.117647058825,-61,-4940000
2021,county,48091,Comal,48265,Kerr,TX,Rural Texas,42,1880000,44761.90476190476,40,1643000,41075.0,2,237000
2021,county,48029,Bexar,48265,Kerr,TX,Rural Texas,307,8804000,28677.524429967427,412,27690000,67208.73786407767,-105,-18886000
2021,county,48491,Williamson,53033,King,WA,Seattle,726,63772000,87840.22038567493,193,12649000,65538.86010362694,533,51123000
2021,county,48453,Travis,53033,King,WA,Seattle,1133,112653000,99428.94969108561,696,60936000,87551.72413793103,437,51717000
2021,county,48029,Bexar,53033,King,WA,Seattle,526,49870000,94809.88593155894,263,12637000,48049.42965779467,263,37233000
2021,county,48491,Williamson,36047,Kings,NY,New York,117,5689000,48623.931623931625,30,1108000,36933.333333333336,87,4581000
2021,county,48453,Travis,36047,Kings,NY,New York,793,80281000,101237.07440100882,260,15827000,60873.07692307692,533,64454000
2021,county,48029,Bexar,36047,Kings,NY,New York,186,7662000,41193.54838709677,84,4379000,52130.95238095238,102,3283000
2021,county,48029,Bexar,53035,Kitsap,WA,Rural Washington,117,2981000,25478.63247863248,66,2209000,33469.69696969697,51,772000
2021,county,48029,Bexar,48273,Kleberg,TX,Rural Texas,115,2876000,25008.695652173912,88,2524000,28681.81818181818,27,352000
2021,county,48453,Travis,47093,Knox,TN,Knoxville,45,2215000,49222.22222222222,79,5364000,67898.73417721518,-34,-3149000
2021,county,48029,Bexar,48283,La Salle,TX,Rural Texas,48,882000,18375.0,31,866000,27935.483870967742,17,16000
2021,county,48453,Travis,22055,Lafayette Parish,LA,Rural Louisiana,54,3117000,57722.22222222222,33,1516000,45939.393939393936,21,1601000
2021,county,48453,Travis,17097,Lake,IL,Chicago,148,9429000,63709.45945945946,54,3588000,66444.44444444444,94,5841000
2021,county,48453,Travis,12069,Lake,FL,Orlando,25,899000,35960.0,40,1965000,49125.0,-15,-1066000
2021,county,48029,Bexar,17097,Lake,IL,Chicago,170,6602000,38835.294117647056,84,2251000,26797.619047619046,86,4351000
2021,county,48491,Williamson,48281,Lampasas,TX,Rural Texas,46,2147000,46673.913043478264,265,12695000,47905.660377358494,-219,-10548000
2021,county,48453,Travis,48281,Lampasas,TX,Rural Texas,43,1370000,31860.46511627907,106,3729000,35179.24528301887,-63,-2359000
2021,county,48453,Travis,41039,Lane,OR,Rural Oregon,49,2219000,45285.71428571428,54,3017000,55870.37037037037,-5,-798000
2021,county,48029,Bexar,41039,Lane,OR,Rural Oregon,82,2697000,32890.243902439026,38,1110000,29210.526315789473,44,1587000
2021,county,48029,Bexar,56021,Laramie,WY,Rural Wyoming,97,2404000,24783.505154639177,64,1496000,23375.0,33,908000
2021,county,48491,Williamson,08069,Larimer,CO,Rural Colorado,38,1741000,45815.78947368421,95,3726000,39221.05263157895,-57,-1985000
2021,county,48453,Travis,08069,Larimer,CO,Rural Colorado,104,5784000,55615.38461538462,179,11031000,61625.69832402235,-75,-5247000
2021,county,48029,Bexar,08069,Larimer,CO,Rural Colorado,75,3179000,42386.666666666664,90,3805000,42277.77777777778,-15,-626000
2021,county,48491,Williamson,12071,Lee,FL,S.W. Florida,48,1900000,39583.333333333336,59,2479000,42016.94915254237,-11,-579000
2021,county,48491,Williamson,48287,Lee,TX,Rural Texas,37,1550000,41891.89189189189,105,2812000,26780.95238095238,-68,-1262000
2021,county,48453,Travis,12071,Lee,FL,S.W. Florida,89,5554000,62404.49438202247,106,5720000,53962.264150943396,-17,-166000
2021,county,48453,Travis,48287,Lee,TX,Rural Texas,69,1912000,27710.144927536232,192,7039000,36661.458333333336,-123,-5127000
2021,county,48029,Bexar,12071,Lee,FL,S.W. Florida,80,2132000,26650.0,97,3074000,31690.721649484534,-17,-942000
2021,county,48453,Travis,12073,Leon,FL,Rural Florida,48,1772000,36916.666666666664,40,1280000,32000.0,8,492000
2021,county,48029,Bexar,13179,Liberty,GA,Rural Georgia,99,2044000,20646.464646464647,62,1265000,20403.225806451614,37,779000
2021,county,48029,Bexar,48297,Live Oak,TX,Rural Texas,61,1551000,25426.22950819672,32,1285000,40156.25,29,266000
2021,county,48491,Williamson,48299,Llano,TX,Rural Texas,78,2383000,30551.28205128205,180,8412000,46733.333333333336,-102,-6029000
2021,county,48453,Travis,48299,Llano,TX,Rural Texas,105,12471000,118771.42857142857,236,19645000,83241.52542372882,-131,-7174000
2021,county,48029,Bexar,48299,Llano,TX,Rural Texas,51,1916000,37568.62745098039,112,7596000,67821.42857142857,-61,-5680000
2021,county,48491,Williamson,06037,Los Angeles,CA,Los Angeles,1083,55707000,51437.67313019391,160,7996000,49975.0,923,47711000
2021,county,48453,Travis,06037,Los Angeles,CA,Los Angeles,2498,294751000,117994.79583666933,793,46946000,59200.504413619165,1705,247805000
2021,county,48209,Hays,06037,Los Angeles,CA,Los Angeles,277,23794000,85898.91696750902,46,1811000,39369.565217391304,231,21983000
2021,county,48091,Comal,06037,Los Angeles,CA,Los Angeles,225,11966000,53182.22222222222,43,1564000,36372.09302325582,182,10402000
2021,county,48029,Bexar,06037,Los Angeles,CA,Los Angeles,1618,58617000,36228.05933250927,494,16403000,33204.45344129555,1124,42214000
2021,county,48453,Travis,51107,Loudoun,VA,Rural Virginia,83,6041000,72783.13253012048,52,2418000,46500.0,31,3623000
2021,county,48029,Bexar,51107,Loudoun,VA,Rural Virginia,137,7155000,52226.277372262775,100,4431000,44310.0,37,2724000
2021,county,48029,Bexar,13185,Lowndes,GA,Rural Georgia,79,1876000,23746.835443037973,52,1329000,25557.69230769231,27,547000
2021,county,48491,Williamson,48303,Lubbock,TX,Rural Texas,208,7417000,35658.653846153844,140,5056000,36114.28571428572,68,2361000
2021,county,48453,Travis,48303,Lubbock,TX,Rural Texas,246,7087000,28808.943089430893,209,8470000,40526.31578947369,37,-1383000
2021,county,48209,Hays,48303,Lubbock,TX,Rural Texas,52,1747000,33596.153846153844,45,1392000,30933.333333333332,7,355000
2021,county,48029,Bexar,48303,Lubbock,TX,Rural Texas,363,9462000,26066.11570247934,322,9965000,30947.2049689441,41,-503000
2021,county,48453,Travis,26099,Macomb,MI,Rural Michigan,37,1724000,46594.59459459459,37,1212000,32756.756756756757,0,512000
2021,county,48453,Travis,01089,Madison,AL,Huntsville,51,2325000,45588.23529411765,47,2306000,49063.82978723404,4,19000
2021,county,48029,Bexar,01089,Madison,AL,Huntsville,61,2748000,45049.18032786885,92,4330000,47065.217391304344,-31,-1582000
2021,county,48453,Travis,12081,Manatee,FL,Rural Florida,43,2221000,51651.16279069767,56,4222000,75392.85714285714,-13,-2001000
2021,county,48491,Williamson,04013,Maricopa,AZ,Phoenix,474,21258000,44848.101265822785,291,13175000,45274.914089347076,183,8083000
2021,county,48453,Travis,04013,Maricopa,AZ,Phoenix,737,49632000,67343.28358208956,575,35616000,61940.86956521739,162,14016000
2021,county,48209,Hays,04013,Maricopa,AZ,Phoenix,119,4173000,35067.226890756305,86,3734000,43418.604651162794,33,439000
2021,county,48091,Comal,04013,Maricopa,AZ,Phoenix,117,5229000,44692.307692307695,39,1627000,41717.94871794872,78,3602000
2021,county,48029,Bexar,04013,Maricopa,AZ,Phoenix,902,29976000,33232.81596452328,663,24706000,37263.95173453997,239,5270000
2021,county,48453,Travis,06041,Marin,CA,Bay Area,143,40614000,284013.986013986,46,5142000,111782.60869565218,97,35472000
2021,county,48453,Travis,18097,Marion,IN,Indianapolis,118,11796000,99966.10169491525,86,4653000,54104.651162790695,32,7143000
2021,county,48029,Bexar,18097,Marion,IN,Indianapolis,123,2772000,22536.585365853658,105,2003000,19076.190476190477,18,769000
2021,county,48453,Travis,48323,Maverick,TX,Rural Texas,58,1081000,18637.931034482757,36,634000,17611.11111111111,22,447000
2021,county,48029,Bexar,48323,Maverick,TX,Rural Texas,562,9710000,17277.580071174376,399,6121000,15340.852130325815,163,3589000
2021,county,48491,Williamson,48309,McLennan,TX,Rural Texas,232,5630000,24267.241379310344,326,11230000,34447.8527607362,-94,-5600000
2021,county,48453,Travis,48309,McLennan,TX,Rural Texas,285,10620000,37263.15789473684,393,15193000,38659.033078880406,-108,-4573000
2021,county,48209,Hays,48309,McLennan,TX,Rural Texas,63,1720000,27301.5873015873,62,1913000,30854.83870967742,1,-193000
2021,county,48029,Bexar,48309,McLennan,TX,Rural Texas,174,5368000,30850.57471264368,240,6680000,27833.333333333332,-66,-1312000
2021,county,48491,Williamson,37119,Mecklenburg,NC,Charlotte,88,4385000,49829.545454545456,54,2334000,43222.22222222222,34,2051000
2021,county,48453,Travis,37119,Mecklenburg,NC,Charlotte,202,16984000,84079.20792079208,180,12606000,70033.33333333333,22,4378000
2021,county,48029,Bexar,37119,Mecklenburg,NC,Charlotte,98,3924000,40040.816326530614,145,7300000,50344.8275862069,-47,-3376000
2021,county,48091,Comal,48325,Medina,TX,Rural Texas,45,1792000,39822.22222222222,44,1669000,37931.818181818184,1,123000
2021,county,48029,Bexar,48325,Medina,TX,Rural Texas,1207,29810000,24697.597348798674,2200,65098000,29590.0,-993,-35288000
2021,county,48491,Williamson,12086,Miami-Dade,FL,Miami,180,4627000,25705.555555555555,55,1391000,25290.909090909092,125,3236000
2021,county,48453,Travis,12086,Miami-Dade,FL,Miami,433,41157000,95050.80831408776,388,25840000,66597.93814432989,45,15317000
2021,county,48029,Bexar,12086,Miami-Dade,FL,Miami,296,8446000,28533.783783783783,242,9545000,39442.14876033058,54,-1099000
2021,county,48453,Travis,25017,Middlesex,MA,Boston,440,45395000,103170.45454545454,216,17965000,83171.29629629629,224,27430000
2021,county,48453,Travis,34023,Middlesex,NJ,New York,104,6644000,63884.61538461538,28,1271000,45392.857142857145,76,5373000
2021,county,48029,Bexar,25017,Middlesex,MA,Boston,90,4957000,55077.77777777778,95,3626000,38168.42105263158,-5,1331000
2021,county,48491,Williamson,48329,Midland,TX,Rural Texas,121,5604000,46314.04958677686,43,1492000,34697.67441860465,78,4112000
2021,county,48453,Travis,48329,Midland,TX,Rural Texas,185,9982000,53956.75675675676,104,6369000,61240.38461538462,81,3613000
2021,county,48091,Comal,48329,Midland,TX,Rural Texas,103,3901000,37873.78640776699,34,1868000,54941.17647058824,69,2033000
2021,county,48029,Bexar,48329,Midland,TX,Rural Texas,320,8677000,27115.625,294,9771000,33234.69387755102,26,-1094000
2021,county,48491,Williamson,48331,Milam,TX,Rural Texas,176,4258000,24193.18181818182,357,12134000,33988.795518207284,-181,-7876000
2021,county,48453,Travis,48331,Milam,TX,Rural Texas,74,1477000,19959.45945945946,176,5470000,31079.545454545456,-102,-3993000
2021,county,48453,Travis,55079,Milwaukee,WI,Milwaukee,116,6078000,52396.55172413793,98,3018000,30795.918367346938,18,3060000
2021,county,48029,Bexar,55079,Milwaukee,WI,Milwaukee,149,4045000,27147.65100671141,85,1706000,20070.58823529412,64,2339000
2021,county,48029,Bexar,01097,Mobile,AL,Mobile,45,1144000,25422.222222222223,45,789000,17533.333333333332,0,355000
2021,county,48453,Travis,36055,Monroe,NY,Rochester,66,3429000,51954.545454545456,41,2273000,55439.0243902439,25,1156000
2021,county,48029,Bexar,36055,Monroe,NY,Rochester,82,2313000,28207.317073170732,36,981000,27250.0,46,1332000
2021,county,48029,Bexar,06053,Monterey,CA,Rural California,155,5059000,32638.709677419356,78,2456000,31487.17948717949,77,2603000
2021,county,48491,Williamson,48339,Montgomery,TX,Houston,286,13285000,46451.04895104895,376,15153000,40300.53191489362,-90,-1868000
2021,county,48453,Travis,48339,Montgomery,TX,Houston,549,35981000,65539.16211293261,607,28020000,46161.44975288303,-58,7961000
2021,county,48453,Travis,24031,Montgomery,MD,D.C.,191,29074000,152219.89528795812,118,6961000,58991.52542372881,73,22113000
2021,county,48453,Travis,42091,Montgomery,PA,Philadelphia,111,7934000,71477.47747747747,27,2331000,86333.33333333333,84,5603000
2021,county,48209,Hays,48339,Montgomery,TX,Houston,132,5571000,42204.545454545456,130,5361000,41238.46153846154,2,210000
2021,county,48091,Comal,48339,Montgomery,TX,Houston,150,7421000,49473.333333333336,95,4872000,51284.21052631579,55,2549000
2021,county,48029,Bexar,48339,Montgomery,TX,Houston,387,15669000,40488.37209302326,490,17930000,36591.836734693876,-103,-2261000
2021,county,48029,Bexar,24031,Montgomery,MD,D.C.,220,10600000,48181.818181818184,156,7044000,45153.846153846156,64,3556000
2021,county,48029,Bexar,47125,Montgomery,TN,Rural Tennessee,266,5175000,19454.887218045114,204,4897000,24004.901960784315,62,278000
2021,county,48029,Bexar,39113,Montgomery,OH,Rural Ohio,161,5492000,34111.801242236026,116,4381000,37767.24137931035,45,1111000
2021,county,48029,Bexar,01101,Montgomery,AL,Montgomery,102,3017000,29578.43137254902,92,3417000,37141.30434782609,10,-400000
2021,county,48029,Bexar,42091,Montgomery,PA,Philadelphia,36,2478000,68833.33333333333,40,1741000,43525.0,-4,737000
2021,county,48491,Williamson,41051,Multnomah,OR,Portland,47,3030000,64468.085106382976,42,1825000,43452.380952380954,5,1205000
2021,county,48453,Travis,41051,Multnomah,OR,Portland,248,24297000,97971.7741935484,229,14605000,63777.29257641921,19,9692000
2021,county,48029,Bexar,41051,Multnomah,OR,Portland,134,5577000,41619.40298507463,67,3614000,53940.298507462685,67,1963000
2021,county,48029,Bexar,13215,Muscogee,GA,Columbus,97,2287000,23577.319587628866,107,2741000,25616.82242990654,-10,-454000
2021,county,48453,Travis,48347,Nacogdoches,TX,Rural Texas,36,1144000,31777.777777777777,72,3669000,50958.333333333336,-36,-2525000
2021,county,48453,Travis,36059,Nassau,NY,New York,163,26074000,159963.19018404908,43,3049000,70906.97674418605,120,23025000
2021,county,48453,Travis,10003,New Castle,DE,Rural Delaware,49,2323000,47408.163265306124,35,2016000,57600.0,14,307000
2021,county,48453,Travis,09009,New Haven,CT,New Haven,77,4511000,58584.41558441558,65,3941000,60630.769230769234,12,570000
2021,county,48491,Williamson,36061,New York,NY,New York,118,10555000,89449.15254237287,31,1829000,59000.0,87,8726000
2021,county,48453,Travis,36061,New York,NY,New York,1000,313236000,313236.0,374,33934000,90732.62032085561,626,279302000
2021,county,48029,Bexar,36061,New York,NY,New York,141,17513000,124205.67375886525,109,7503000,68834.8623853211,32,10010000
2021,county,48029,Bexar,51700,Newport News city,VA,Hampton Roads,138,3219000,23326.08695652174,70,1803000,25757.14285714286,68,1416000
2021,county,48453,Travis,25021,Norfolk,MA,Boston,102,6940000,68039.2156862745,55,4900000,89090.90909090909,47,2040000
2021,county,48029,Bexar,51710,Norfolk city,VA,Hampton Roads,93,2150000,23118.279569892475,99,3071000,31020.20202020202,-6,-921000
2021,county,48491,Williamson,48355,Nueces,TX,Rural Texas,268,9386000,35022.388059701494,202,5930000,29356.435643564357,66,3456000
2021,county,48453,Travis,48355,Nueces,TX,Rural Texas,432,15997000,37030.09259259259,357,17771000,49778.711484593834,75,-1774000
2021,county,48209,Hays,48355,Nueces,TX,Rural Texas,121,7651000,63231.40495867769,129,3464000,26852.713178294573,-8,4187000
2021,county,48091,Comal,48355,Nueces,TX,Rural Texas,172,7043000,40947.67441860465,95,4461000,46957.89473684211,77,2582000
2021,county,48029,Bexar,48355,Nueces,TX,Rural Texas,1428,47311000,33130.95238095238,1020,30914000,30307.843137254902,408,16397000
2021,county,48453,Travis,26125,Oakland,MI,Detroit,200,13307000,66535.0,110,8003000,72754.54545454546,90,5304000
2021,county,48029,Bexar,26125,Oakland,MI,Detroit,118,4243000,35957.627118644064,91,3248000,35692.307692307695,27,995000
2021,county,48453,Travis,12091,Okaloosa,FL,FL Panhandle,47,1879000,39978.72340425532,44,1971000,44795.454545454544,3,-92000
2021,county,48029,Bexar,12091,Okaloosa,FL,FL Panhandle,337,8774000,26035.60830860534,290,8410000,29000.0,47,364000
2021,county,48491,Williamson,40109,Oklahoma,OK,Oklahoma City,91,5452000,59912.08791208791,70,2198000,31400.0,21,3254000
2021,county,48453,Travis,40109,Oklahoma,OK,Oklahoma City,162,7087000,43746.91358024691,153,6743000,44071.8954248366,9,344000
2021,county,48029,Bexar,40109,Oklahoma,OK,Oklahoma City,228,8996000,39456.14035087719,278,9810000,35287.76978417266,-50,-814000
2021,county,48029,Bexar,37133,Onslow,NC,Rural North Carolina,204,3768000,18470.58823529412,92,1801000,19576.08695652174,112,1967000
2021,county,48491,Williamson,06059,Orange,CA,Los Angeles,687,37621000,54761.28093158661,97,4480000,46185.56701030928,590,33141000
2021,county,48491,Williamson,12095,Orange,FL,Orlando,141,2949000,20914.893617021276,89,3068000,34471.910112359554,52,-119000
2021,county,48453,Travis,06059,Orange,CA,Los Angeles,970,122943000,126745.36082474227,358,18589000,51924.581005586595,612,104354000
2021,county,48453,Travis,12095,Orange,FL,Orlando,206,8464000,41087.3786407767,159,8934000,56188.67924528302,47,-470000
2021,county,48029,Bexar,06059,Orange,CA,Los Angeles,708,33594000,47449.15254237288,191,8304000,43476.43979057592,517,25290000
2021,county,48029,Bexar,12095,Orange,FL,Orlando,191,4645000,24319.37172774869,246,9042000,36756.09756097561,-55,-4397000
2021,county,48453,Travis,22071,Orleans Parish,LA,New Orleans,163,10063000,61736.1963190184,120,6463000,53858.333333333336,43,3600000
2021,county,48029,Bexar,22071,Orleans Parish,LA,New Orleans,92,3558000,38673.913043478264,82,2612000,31853.658536585364,10,946000
2021,county,48029,Bexar,12097,Osceola,FL,Orlando,72,1521000,21125.0,66,2170000,32878.78787878788,6,-649000
2021,county,48029,Bexar,35035,Otero,NM,Rural New Mexico,114,2386000,20929.824561403508,76,1787000,23513.157894736843,38,599000
2021,county,48491,Williamson,12099,Palm Beach,FL,Miami,79,3979000,50367.08860759494,66,2996000,45393.93939393939,13,983000
2021,county,48453,Travis,12099,Palm Beach,FL,Miami,174,11058000,63551.724137931036,143,14652000,102461.53846153847,31,-3594000
2021,county,48029,Bexar,12099,Palm Beach,FL,Miami,147,5335000,36292.51700680272,121,11634000,96148.76033057852,26,-6299000
2021,county,48491,Williamson,48367,Parker,TX,Dallas-Fort Worth,39,1380000,35384.61538461538,75,3880000,51733.333333333336,-36,-2500000
2021,county,48453,Travis,48367,Parker,TX,Dallas-Fort Worth,60,2696000,44933.333333333336,93,7277000,78247.31182795699,-33,-4581000
2021,county,48029,Bexar,48367,Parker,TX,Dallas-Fort Worth,78,1708000,21897.4358974359,89,3687000,41426.96629213483,-11,-1979000
2021,county,48453,Travis,42101,Philadelphia,PA,Philadelphia,185,12775000,69054.05405405405,164,9659000,58896.34146341463,21,3116000
2021,county,48029,Bexar,42101,Philadelphia,PA,Philadelphia,121,4581000,37859.50413223141,66,2366000,35848.48484848485,55,2215000
2021,county,48491,Williamson,53053,Pierce,WA,Seattle,106,4886000,46094.339622641506,75,2759000,36786.666666666664,31,2127000
2021,county,48453,Travis,53053,Pierce,WA,Seattle,122,8116000,66524.59016393442,100,5212000,52120.0,22,2904000
2021,county,48029,Bexar,53053,Pierce,WA,Seattle,572,18251000,31907.34265734266,310,8608000,27767.74193548387,262,9643000
2021,county,48491,Williamson,04019,Pima,AZ,Tucson,74,3052000,41243.24324324324,58,2252000,38827.58620689655,16,800000
2021,county,48453,Travis,04019,Pima,AZ,Tucson,134,7016000,52358.20895522388,135,7376000,54637.03703703704,-1,-360000
2021,county,48029,Bexar,04019,Pima,AZ,Tucson,377,9111000,24167.10875331565,246,7278000,29585.365853658535,131,1833000
2021,county,48029,Bexar,04021,Pinal,AZ,Phoenix,91,2501000,27483.516483516483,55,1991000,36200.0,36,510000
2021,county,48453,Travis,12103,Pinellas,FL,Tampa,99,4517000,45626.26262626263,146,10923000,74815.06849315068,-47,-6406000
2021,county,48029,Bexar,12103,Pinellas,FL,Tampa,113,2865000,25353.982300884956,91,3782000,41560.43956043956,22,-917000
2021,county,48453,Travis,06061,Placer,CA,Sacramento,78,4715000,60448.717948717946,32,1994000,62312.5,46,2721000
2021,county,48029,Bexar,06061,Placer,CA,Sacramento,90,2928000,32533.333333333332,45,1540000,34222.22222222222,45,1388000
2021,county,48491,Williamson,48373,Polk,TX,Rural Texas,37,2164000,58486.48648648649,76,3207000,42197.36842105263,-39,-1043000
2021,county,48453,Travis,19153,Polk,IA,Rural Iowa,70,3068000,43828.57142857143,56,3938000,70321.42857142857,14,-870000
2021,county,48453,Travis,48373,Polk,TX,Rural Texas,44,1672000,38000.0,92,4786000,52021.739130434784,-48,-3114000
2021,county,48453,Travis,12105,Polk,FL,Orlando,36,1500000,41666.666666666664,53,1714000,32339.622641509435,-17,-214000
2021,county,48029,Bexar,19153,Polk,IA,Rural Iowa,55,1792000,32581.81818181818,63,1048000,16634.920634920636,-8,744000
2021,county,48029,Bexar,12105,Polk,FL,Orlando,57,1181000,20719.298245614034,92,1683000,18293.478260869564,-35,-502000
2021,county,48453,Travis,48375,Potter,TX,Rural Texas,37,1134000,30648.64864864865,29,1496000,51586.206896551725,8,-362000
2021,county,48029,Bexar,48375,Potter,TX,Rural Texas,65,1268000,19507.69230769231,32,619000,19343.75,33,649000
2021,county,48453,Travis,24033,Prince George,MD,Rural Maryland,67,2791000,41656.71641791045,46,1707000,37108.69565217391,21,1084000
2021,county,48029,Bexar,24033,Prince George,MD,Rural Maryland,121,4445000,36735.53719008264,95,4008000,42189.47368421053,26,437000
2021,county,48029,Bexar,51153,Prince William,VA,Rural Virginia,204,6773000,33200.98039215686,121,3587000,29644.628099173555,83,3186000
2021,county,48453,Travis,44007,Providence,RI,Providence,47,2278000,48468.085106382976,49,1947000,39734.69387755102,-2,331000
2021,county,48453,Travis,05119,Pulaski,AR,Little Rock,90,4083000,45366.666666666664,56,2963000,52910.71428571428,34,1120000
2021,county,48029,Bexar,05119,Pulaski,AR,Little Rock,111,3696000,33297.2972972973,78,2526000,32384.615384615383,33,1170000
2021,county,48029,Bexar,29169,Pulaski,MO,Rural Missouri,105,2206000,21009.52380952381,98,2826000,28836.73469387755,7,-620000
2021,county,48453,Travis,36081,Queens,NY,New York,303,19203000,63376.237623762376,79,2505000,31708.86075949367,224,16698000
2021,county,48029,Bexar,36081,Queens,NY,New York,141,6053000,42929.0780141844,49,1110000,22653.061224489797,92,4943000
2021,county,48453,Travis,27123,Ramsey,MN,Minneapolis,72,4010000,55694.444444444445,46,2662000,57869.565217391304,26,1348000
2021,county,48029,Bexar,27123,Ramsey,MN,Minneapolis,48,1483000,30895.833333333332,29,1314000,45310.34482758621,19,169000
2021,county,48491,Williamson,48381,Randall,TX,Rural Texas,61,1900000,31147.54098360656,46,1420000,30869.565217391304,15,480000
2021,county,48453,Travis,48381,Randall,TX,Rural Texas,58,1936000,33379.31034482759,60,2756000,45933.333333333336,-2,-820000
2021,county,48029,Bexar,48381,Randall,TX,Rural Texas,119,3866000,32487.394957983193,91,2690000,29560.43956043956,28,1176000
2021,county,48029,Bexar,45079,Richland,SC,Columbia,111,3874000,34900.9009009009,83,2285000,27530.12048192771,28,1589000
2021,county,48029,Bexar,13245,Richmond,GA,Rural Georgia,99,2358000,23818.18181818182,65,1943000,29892.30769230769,34,415000
2021,county,48453,Travis,51760,Richmond city,VA,Richmond,56,5709000,101946.42857142857,56,3528000,63000.0,0,2181000
2021,county,48029,Bexar,20161,Riley,KS,Rural Kansas,43,1351000,31418.60465116279,40,754000,18850.0,3,597000
2021,county,48491,Williamson,06065,Riverside,CA,San Bernardino-Riverside,362,15449000,42676.7955801105,69,2654000,38463.76811594203,293,12795000
2021,county,48453,Travis,06065,Riverside,CA,San Bernardino-Riverside,290,13161000,45382.75862068965,137,4392000,32058.394160583943,153,8769000
2021,county,48029,Bexar,06065,Riverside,CA,San Bernardino-Riverside,656,20861000,31800.30487804878,205,4673000,22795.121951219513,451,16188000
2021,county,48453,Travis,48397,Rockwall,TX,Dallas-Fort Worth,54,2944000,54518.51851851852,68,3941000,57955.882352941175,-14,-997000
2021,county,48029,Bexar,48397,Rockwall,TX,Dallas-Fort Worth,43,3282000,76325.58139534884,59,2710000,45932.20338983051,-16,572000
2021,county,48491,Williamson,06067,Sacramento,CA,Sacramento,236,11363000,48148.30508474576,44,2137000,48568.181818181816,192,9226000
2021,county,48453,Travis,06067,Sacramento,CA,Sacramento,192,11000000,57291.666666666664,100,4873000,48730.0,92,6127000
2021,county,48029,Bexar,06067,Sacramento,CA,Sacramento,318,14814000,46584.90566037736,100,2726000,27260.0,218,12088000
2021,county,48491,Williamson,49035,Salt Lake,UT,Salt Lake,153,7294000,47673.202614379086,39,2181000,55923.07692307692,114,5113000
2021,county,48453,Travis,49035,Salt Lake,UT,Salt Lake,205,12242000,59717.07317073171,178,8414000,47269.66292134832,27,3828000
2021,county,48029,Bexar,49035,Salt Lake,UT,Salt Lake,214,6387000,29845.794392523363,158,4809000,30436.708860759492,56,1578000
2021,county,48491,Williamson,06071,San Bernardino,CA,San Bernardino-Riverside,267,9145000,34250.93632958802,80,2632000,32900.0,187,6513000
2021,county,48453,Travis,06071,San Bernardino,CA,San Bernardino-Riverside,180,7672000,42622.22222222222,97,2239000,23082.474226804123,83,5433000
2021,county,48029,Bexar,06071,San Bernardino,CA,San Bernardino-Riverside,563,14482000,25722.91296625222,187,5245000,28048.12834224599,376,9237000
2021,county,48491,Williamson,06073,San Diego,CA,San Diego,604,30420000,50364.23841059603,188,7625000,40558.51063829787,416,22795000
2021,county,48453,Travis,06073,San Diego,CA,San Diego,995,76860000,77246.23115577889,541,38553000,71262.47689463956,454,38307000
2021,county,48209,Hays,06073,San Diego,CA,San Diego,200,12113000,60565.0,47,3100000,65957.44680851063,153,9013000
2021,county,48091,Comal,06073,San Diego,CA,San Diego,232,12374000,53336.206896551725,50,1691000,33820.0,182,10683000
2021,county,48029,Bexar,06073,San Diego,CA,San Diego,1313,38963000,29674.790555978674,598,18061000,30202.341137123745,715,20902000
2021,county,48453,Travis,06075,San Francisco,CA,Bay Area,1048,442410000,422146.9465648855,181,16089000,88889.50276243094,867,426321000
2021,county,48029,Bexar,06075,San Francisco,CA,Bay Area,83,9290000,111927.7108433735,44,3466000,78772.72727272728,39,5824000
2021,county,48453,Travis,06077,San Joaquin,CA,Bay Area,56,5909000,105517.85714285714,35,2220000,63428.57142857143,21,3689000
2021,county,48029,Bexar,06077,San Joaquin,CA,Bay Area,99,3171000,32030.303030303032,54,1147000,21240.74074074074,45,2024000
2021,county,48453,Travis,06079,San Luis Obispo,CA,Rural California,52,2612000,50230.769230769234,43,2255000,52441.86046511628,9,357000
2021,county,48453,Travis,06081,San Mateo,CA,Bay Area,613,256154000,417869.4942903752,98,6712000,68489.79591836735,515,249442000
2021,county,48453,Travis,48409,San Patricio,TX,Rural Texas,73,2003000,27438.35616438356,79,2730000,34556.962025316454,-6,-727000
2021,county,48029,Bexar,48409,San Patricio,TX,Rural Texas,160,3540000,22125.0,183,4257000,23262.29508196721,-23,-717000
2021,county,48453,Travis,06083,Santa Barbara,CA,Rural California,136,13091000,96257.35294117648,48,2223000,46312.5,88,10868000
2021,county,48029,Bexar,06083,Santa Barbara,CA,Rural California,107,5605000,52383.17757009346,43,1112000,25860.46511627907,64,4493000
2021,county,48491,Williamson,06085,Santa Clara,CA,Bay Area,1388,139894000,100788.18443804035,138,8899000,64485.50724637681,1250,130995000
2021,county,48453,Travis,06085,Santa Clara,CA,Bay Area,1865,341516000,183118.4986595174,356,30523000,85738.76404494382,1509,310993000
2021,county,48029,Bexar,06085,Santa Clara,CA,Bay Area,221,21451000,97063.34841628959,128,6947000,54273.4375,93,14504000
2021,county,48453,Travis,35049,Santa Fe,NM,Rural New Mexico,57,6447000,113105.26315789473,131,11674000,89114.50381679389,-74,-5227000
2021,county,48029,Bexar,12113,Santa Rosa,FL,FL Panhandle,102,2762000,27078.43137254902,120,2800000,23333.333333333332,-18,-38000
2021,county,48453,Travis,12115,Sarasota,FL,S.W. Florida,37,956000,25837.837837837837,75,4764000,63520.0,-38,-3808000
2021,county,48029,Bexar,31153,Sarpy,NE,Omaha,182,5406000,29703.296703296703,120,3451000,28758.333333333332,62,1955000
2021,county,48453,Travis,20173,Sedgwick,KS,Rural Kansas,59,5686000,96372.8813559322,37,1827000,49378.37837837838,22,3859000
2021,county,48029,Bexar,20173,Sedgwick,KS,Rural Kansas,134,4541000,33888.05970149254,99,2937000,29666.666666666668,35,1604000
2021,county,48453,Travis,12117,Seminole,FL,Orlando,58,2513000,43327.58620689655,41,1971000,48073.170731707316,17,542000
2021,county,48029,Bexar,12117,Seminole,FL,Orlando,28,997000,35607.142857142855,85,2656000,31247.058823529413,-57,-1659000
2021,county,48491,Williamson,47157,Shelby,TN,Memphis,48,1577000,32854.166666666664,57,1941000,34052.63157894737,-9,-364000
2021,county,48453,Travis,47157,Shelby,TN,Memphis,135,8224000,60918.51851851852,69,3400000,49275.362318840576,66,4824000
2021,county,48029,Bexar,47157,Shelby,TN,Memphis,176,3978000,22602.272727272728,132,3353000,25401.515151515152,44,625000
2021,county,48491,Williamson,48423,Smith,TX,Rural Texas,93,3246000,34903.22580645161,140,4852000,34657.142857142855,-47,-1606000
2021,county,48453,Travis,48423,Smith,TX,Rural Texas,142,7006000,49338.028169014084,189,15216000,80507.93650793651,-47,-8210000
2021,county,48029,Bexar,48423,Smith,TX,Rural Texas,141,5598000,39702.12765957447,132,6182000,46833.333333333336,9,-584000
2021,county,48491,Williamson,53061,Snohomish,WA,Seattle,167,8347000,49982.03592814371,64,2630000,41093.75,103,5717000
2021,county,48453,Travis,53061,Snohomish,WA,Seattle,159,9749000,61314.46540880503,101,5993000,59336.63366336634,58,3756000
2021,county,48029,Bexar,53061,Snohomish,WA,Seattle,360,16294000,45261.11111111111,89,3174000,35662.92134831461,271,13120000
2021,county,48029,Bexar,06095,Solano,CA,Bay Area,261,9589000,36739.46360153257,166,6272000,37783.132530120485,95,3317000
2021,county,48453,Travis,34035,Somerset,NJ,New York,46,8293000,180282.60869565216,60,3200000,53333.333333333336,-14,5093000
2021,county,48453,Travis,06097,Sonoma,CA,Bay Area,102,17064000,167294.11764705883,40,2644000,66100.0,62,14420000
2021,county,48453,Travis,53063,Spokane,WA,Spokane,60,2918000,48633.333333333336,66,2608000,39515.15151515151,-6,310000
2021,county,48029,Bexar,53063,Spokane,WA,Spokane,116,5155000,44439.65517241379,107,3456000,32299.065420560746,9,1699000
2021,county,48453,Travis,29183,St. Charles,MO,St. Louis,41,2066000,50390.243902439026,29,1736000,59862.06896551724,12,330000
2021,county,48029,Bexar,17163,St. Clair,IL,St. Louis,163,4928000,30233.12883435583,149,4356000,29234.89932885906,14,572000
2021,county,48453,Travis,12109,St. Johns,FL,Jacksonville,35,2055000,58714.28571428572,56,6641000,118589.28571428571,-21,-4586000
2021,county,48491,Williamson,29189,St. Louis,MO,St. Louis,76,3618000,47605.26315789474,52,1786000,34346.153846153844,24,1832000
2021,county,48453,Travis,29189,St. Louis,MO,St. Louis,129,10383000,80488.37209302325,77,8203000,106532.46753246753,52,2180000
2021,county,48029,Bexar,29189,St. Louis,MO,St. Louis,167,5425000,32485.02994011976,101,3530000,34950.49504950495,66,1895000
2021,county,48453,Travis,29510,St. Louis city,MO,Rural Missouri,71,3458000,48704.22535211268,50,2272000,45440.0,21,1186000
2021,county,48029,Bexar,29510,St. Louis city,MO,Rural Missouri,32,1306000,40812.5,37,1578000,42648.64864864865,-5,-272000
2021,county,48453,Travis,22103,St. Tammany Parish,LA,New Orleans,42,2521000,60023.80952380953,32,1343000,41968.75,10,1178000
2021,county,48029,Bexar,22103,St. Tammany Parish,LA,New Orleans,47,1513000,32191.489361702126,54,1894000,35074.07407407407,-7,-381000
2021,county,48029,Bexar,48427,Starr,TX,Rural Texas,49,1097000,22387.755102040817,44,792000,18000.0,5,305000
2021,county,48453,Travis,25025,Suffolk,MA,Boston,272,26928000,99000.0,123,8488000,69008.13008130081,149,18440000
2021,county,48453,Travis,36103,Suffolk,NY,New York,130,7215000,55500.0,41,3405000,83048.78048780488,89,3810000
2021,county,48029,Bexar,25025,Suffolk,MA,Boston,57,3219000,56473.68421052631,38,2648000,69684.21052631579,19,571000
2021,county,48453,Travis,39153,Summit,OH,Rural Ohio,30,1572000,52400.0,50,2082000,41640.0,-20,-510000
2021,county,48029,Bexar,45085,Sumter,SC,Rural South Carolina,115,2664000,23165.217391304348,59,1666000,28237.28813559322,56,998000
2021,county,48491,Williamson,48439,Tarrant,TX,Dallas-Fort Worth,634,26742000,42179.81072555205,595,23525000,39537.815126050424,39,3217000
2021,county,48453,Travis,48439,Tarrant,TX,Dallas-Fort Worth,1109,57152000,51534.71596032462,1274,136805000,107382.26059654632,-165,-79653000
2021,county,48209,Hays,48439,Tarrant,TX,Dallas-Fort Worth,189,6911000,36566.137566137564,178,7488000,42067.41573033708,11,-577000
2021,county,48091,Comal,48439,Tarrant,TX,Dallas-Fort Worth,190,9283000,48857.89473684211,97,10304000,106226.80412371134,93,-1021000
2021,county,48029,Bexar,48439,Tarrant,TX,Dallas-Fort Worth,1258,38871000,30899.046104928457,1197,40068000,33473.68421052631,61,-1197000
2021,county,48491,Williamson,48441,Taylor,TX,Rural Texas,70,2073000,29614.285714285714,117,4238000,36222.22222222222,-47,-2165000
2021,county,48453,Travis,48441,Taylor,TX,Rural Texas,122,2946000,24147.54098360656,75,2165000,28866.666666666668,47,781000
2021,county,48029,Bexar,48441,Taylor,TX,Rural Texas,272,6812000,25044.117647058825,226,5568000,24637.16814159292,46,1244000
2021,county,48453,Travis,53067,Thurston,WA,Rural Washington,41,1473000,35926.829268292684,31,1483000,47838.709677419356,10,-10000
2021,county,48029,Bexar,53067,Thurston,WA,Rural Washington,224,5747000,25656.25,133,4118000,30962.406015037595,91,1629000
2021,county,48491,Williamson,48451,Tom Green,TX,Rural Texas,60,1598000,26633.333333333332,70,2713000,38757.142857142855,-10,-1115000
2021,county,48453,Travis,48451,Tom Green,TX,Rural Texas,135,3769000,27918.51851851852,92,2400000,26086.956521739132,43,1369000
2021,county,48029,Bexar,48451,Tom Green,TX,Rural Texas,343,8887000,25909.620991253643,226,4909000,21721.2389380531,117,3978000
2021,county,48491,Williamson,48453,Travis,TX,Austin,23526,1047467000,44523.80345150047,13429,567068000,42227.12041105071,10097,480399000
2021,county,48209,Hays,48453,Travis,TX,Austin,9764,526199000,53891.74518639901,3793,168259000,44360.40073820195,5971,357940000
2021,county,48091,Comal,48453,Travis,TX,Austin,934,53343000,57112.41970021413,388,18398000,47417.52577319588,546,34945000
2021,county,48029,Bexar,48453,Travis,TX,Austin,2765,130012000,47020.614828209764,2314,106925000,46207.86516853933,451,23087000
2021,county,48491,Williamson,40143,Tulsa,OK,Tulsa,40,1714000,42850.0,106,3811000,35952.83018867925,-66,-2097000
2021,county,48453,Travis,40143,Tulsa,OK,Tulsa,99,6293000,63565.656565656565,139,6422000,46201.438848920865,-40,-129000
2021,county,48029,Bexar,40143,Tulsa,OK,Tulsa,134,4268000,31850.746268656716,103,3772000,36621.35922330097,31,496000
2021,county,48491,Williamson,49049,Utah,UT,Rural Utah,131,3893000,29717.557251908398,69,2012000,29159.420289855072,62,1881000
2021,county,48453,Travis,49049,Utah,UT,Rural Utah,119,3550000,29831.932773109245,71,3555000,50070.42253521127,48,-5000
2021,county,48029,Bexar,49049,Utah,UT,Rural Utah,188,3713000,19750.0,122,3722000,30508.196721311477,66,-9000
2021,county,48029,Bexar,48463,Uvalde,TX,Rural Texas,211,5204000,24663.50710900474,193,6339000,32844.55958549223,18,-1135000
2021,county,48453,Travis,48465,Val Verde,TX,Rural Texas,29,1169000,40310.34482758621,35,877000,25057.14285714286,-6,292000
2021,county,48029,Bexar,48465,Val Verde,TX,Rural Texas,330,7503000,22736.363636363636,293,7276000,24832.764505119452,37,227000
2021,county,48453,Travis,06111,Ventura,CA,Los Angeles,154,12685000,82370.12987012987,82,4218000,51439.0243902439,72,8467000
2021,county,48029,Bexar,06111,Ventura,CA,Los Angeles,201,6735000,33507.46268656717,41,1630000,39756.09756097561,160,5105000
2021,county,48029,Bexar,22115,Vernon Parish,LA,Rural Louisiana,128,2547000,19898.4375,55,1410000,25636.363636363636,73,1137000
2021,county,48491,Williamson,48469,Victoria,TX,Rural Texas,57,2168000,38035.087719298244,50,1681000,33620.0,7,487000
2021,county,48453,Travis,48469,Victoria,TX,Rural Texas,127,4660000,36692.913385826774,92,2698000,29326.08695652174,35,1962000
2021,county,48091,Comal,48469,Victoria,TX,Rural Texas,52,1667000,32057.69230769231,29,843000,29068.96551724138,23,824000
2021,county,48029,Bexar,48469,Victoria,TX,Rural Texas,269,6740000,25055.762081784385,170,4950000,29117.647058823528,99,1790000
2021,county,48453,Travis,51810,Virginia Beach city,VA,Hampton Roads,50,2761000,55220.0,54,1683000,31166.666666666668,-4,1078000
2021,county,48029,Bexar,51810,Virginia Beach city,VA,Hampton Roads,157,4229000,26936.305732484077,135,3905000,28925.925925925927,22,324000
2021,county,48491,Williamson,37183,Wake,NC,Raleigh,111,5512000,49657.657657657655,134,6899000,51485.07462686567,-23,-1387000
2021,county,48453,Travis,37183,Wake,NC,Raleigh,235,14927000,63519.14893617021,259,22148000,85513.51351351352,-24,-7221000
2021,county,48029,Bexar,37183,Wake,NC,Raleigh,138,5218000,37811.59420289855,109,5706000,52348.62385321101,29,-488000
2021,county,48453,Travis,48471,Walker,TX,Rural Texas,73,1648000,22575.342465753423,58,1167000,20120.689655172413,15,481000
2021,county,48029,Bexar,48471,Walker,TX,Rural Texas,62,1548000,24967.74193548387,69,1535000,22246.376811594204,-7,13000
2021,county,48029,Bexar,38101,Ward,ND,Rural North Dakota,105,2333000,22219.04761904762,75,1702000,22693.333333333332,30,631000
2021,county,48491,Williamson,41067,Washington,OR,Portland,197,12095000,61395.93908629441,52,2504000,48153.846153846156,145,9591000
2021,county,48453,Travis,41067,Washington,OR,Portland,226,17806000,78787.61061946902,128,6840000,53437.5,98,10966000
2021,county,48453,Travis,05143,Washington,AR,Rural Arkansas,54,2455000,45462.96296296296,76,3805000,50065.78947368421,-22,-1350000
2021,county,48453,Travis,48477,Washington,TX,Rural Texas,46,1477000,32108.695652173912,53,2586000,48792.45283018868,-7,-1109000
2021,county,48029,Bexar,41067,Washington,OR,Portland,150,6218000,41453.333333333336,64,1682000,26281.25,86,4536000
2021,county,48029,Bexar,05143,Washington,AR,Rural Arkansas,30,869000,28966.666666666668,33,1057000,32030.303030303032,-3,-188000
2021,county,48453,Travis,32031,Washoe,NV,Rural Nevada,176,28545000,162187.5,54,3299000,61092.59259259259,122,25246000
2021,county,48029,Bexar,32031,Washoe,NV,Rural Nevada,122,4042000,33131.147540983606,38,1771000,46605.26315789474,84,2271000
2021,county,48453,Travis,26161,Washtenaw,MI,Rural Michigan,88,5534000,62886.36363636364,74,4185000,56554.05405405405,14,1349000
2021,county,48453,Travis,55133,Waukesha,WI,Milwaukee,53,3574000,67433.96226415095,36,2343000,65083.333333333336,17,1231000
2021,county,48491,Williamson,26163,Wayne,MI,Detroit,52,2299000,44211.53846153846,48,1384000,28833.333333333332,4,915000
2021,county,48453,Travis,26163,Wayne,MI,Detroit,80,4295000,53687.5,118,4111000,34838.983050847455,-38,184000
2021,county,48029,Bexar,26163,Wayne,MI,Detroit,97,2401000,24752.577319587628,101,2722000,26950.49504950495,-4,-321000
2021,county,48029,Bexar,37191,Wayne,NC,Rural North Carolina,86,1670000,19418.60465116279,57,1020000,17894.736842105263,29,650000
2021,county,48491,Williamson,48479,Webb,TX,Rural Texas,60,1183000,19716.666666666668,42,1220000,29047.619047619046,18,-37000
2021,county,48453,Travis,48479,Webb,TX,Rural Texas,186,5404000,29053.763440860213,111,2811000,25324.324324324323,75,2593000
2021,county,48029,Bexar,48479,Webb,TX,Rural Texas,1453,29116000,20038.54094975912,659,13157000,19965.098634294387,794,15959000
2021,county,48029,Bexar,49057,Weber,UT,Rural Utah,59,1432000,24271.186440677968,48,1431000,29812.5,11,1000
2021,county,48453,Travis,08123,Weld,CO,Rural Colorado,34,1621000,47676.470588235294,46,2171000,47195.65217391304,-12,-550000
2021,county,48029,Bexar,08123,Weld,CO,Rural Colorado,81,2469000,30481.48148148148,75,2476000,33013.333333333336,6,-7000
2021,county,48453,Travis,36119,Westchester,NY,New York,129,25876000,200589.1472868217,47,4477000,95255.31914893616,82,21399000
2021,county,48453,Travis,48485,Wichita,TX,Rural Texas,45,1591000,35355.555555555555,64,2762000,43156.25,-19,-1171000
2021,county,48029,Bexar,48485,Wichita,TX,Rural Texas,91,2466000,27098.9010989011,114,3396000,29789.473684210527,-23,-930000
2021,county,48453,Travis,17197,Will,IL,Chicago,101,6882000,68138.61386138614,34,1422000,41823.529411764706,67,5460000
2021,county,48453,Travis,48491,Williamson,TX,Austin,13429,567068000,42227.12041105071,23526,1047467000,44523.80345150047,-10097,-480399000
2021,county,48453,Travis,47187,Williamson,TN,Nashville,41,3073000,74951.21951219512,96,6535000,68072.91666666667,-55,-3462000
2021,county,48209,Hays,48491,Williamson,TX,Austin,979,39310000,40153.217568947905,813,28700000,35301.35301353013,166,10610000
2021,county,48091,Comal,48491,Williamson,TX,Austin,332,17657000,53183.73493975904,184,7282000,39576.086956521736,148,10375000
2021,county,48029,Bexar,48491,Williamson,TX,Austin,1104,39302000,35599.637681159424,939,33186000,35341.85303514377,165,6116000
2021,county,48091,Comal,48493,Wilson,TX,Rural Texas,107,5692000,53196.26168224299,135,4922000,36459.25925925926,-28,770000
2021,county,48029,Bexar,48493,Wilson,TX,Rural Texas,1134,30982000,27320.987654320987,1824,55546000,30452.85087719298,-690,-24564000
2021,county,48453,Travis,25027,Worcester,MA,Rural Massachusetts,91,4214000,46307.692307692305,43,2349000,54627.90697674418,48,1865000
2021,county,48029,Bexar,25027,Worcester,MA,Rural Massachusetts,54,2003000,37092.59259259259,43,1239000,28813.95348837209,11,764000
2021,county,48453,Travis,04025,Yavapai,AZ,Rural Arizona,41,1635000,39878.04878048781,31,1806000,58258.06451612903,10,-171000
2021,county,48029,Bexar,51199,York,VA,Hampton Roads,130,3040000,23384.615384615383,87,2342000,26919.540229885057,43,698000
2021,county,48029,Bexar,48507,Zavala,TX,Rural Texas,90,1695000,18833.333333333332,32,864000,27000.0,58,831000
2021,total,48491,Williamson,96000,,,,61761,2934702000,47517.07388157575,42156,1715260000,40688.39548344245,19605,1219442000
2021,total,48453,Travis,96000,,,,83508,6544494000,78369.665181779,91586,4682281000,51124.41857925884,-8078,1862213000
2021,total,48209,Hays,96000,,,,23571,1167835000,49545.41597726019,15983,604924000,37847.9634611775,7588,562911000
2021,total,48091,Comal,96000,,,,20762,975327000,46976.543685579425,11481,464702000,40475.7425311384,9281,510625000
2021,total,48029,Bexar,96000,,,,88193,2961994000,33585.363917771254,80478,2750286000,34174.38306120927,7715,211708000
2022,county,48453,Travis,16001,Ada,ID,Rural Idaho,116,7348000,63344.8275862069,124,6872000,55419.354838709674,-8,476000
2022,county,48029,Bexar,16001,Ada,ID,Rural Idaho,67,2234000,33343.28358208955,76,2312000,30421.052631578947,-9,-78000
2022,county,48491,Williamson,08001,Adams,CO,Denver,38,1795000,47236.84210526316,44,1615000,36704.545454545456,-6,180000
2022,county,48453,Travis,08001,Adams,CO,Denver,71,3387000,47704.22535211268,74,4429000,59851.35135135135,-3,-1042000
2022,county,48029,Bexar,08001,Adams,CO,Denver,177,5202000,29389.830508474577,105,4750000,45238.09523809524,72,452000
2022,county,48491,Williamson,06001,Alameda,CA,Bay Area,747,77496000,103742.9718875502,105,6251000,59533.333333333336,642,71245000
2022,county,48453,Travis,06001,Alameda,CA,Bay Area,800,136439000,170548.75,244,22654000,92844.26229508196,556,113785000
2022,county,48029,Bexar,06001,Alameda,CA,Bay Area,229,8941000,39043.66812227074,91,3975000,43681.318681318684,138,4966000
2022,county,48453,Travis,36001,Albany,NY,Rural New York,41,3681000,89780.48780487805,32,1561000,48781.25,9,2120000
2022,county,48453,Travis,51003,Albemarle,VA,Rural Virginia,47,2585000,55000.0,51,3466000,67960.7843137255,-4,-881000
2022,county,48453,Travis,51510,Alexandria city,VA,D.C.,54,5958000,110333.33333333333,52,3771000,72519.23076923077,2,2187000
2022,county,48029,Bexar,51510,Alexandria city,VA,D.C.,70,4230000,60428.57142857143,65,3872000,59569.230769230766,5,358000
2022,county,48491,Williamson,42003,Allegheny,PA,Pittsburgh,75,4651000,62013.333333333336,45,2647000,58822.22222222222,30,2004000
2022,county,48453,Travis,42003,Allegheny,PA,Pittsburgh,209,16959000,81143.54066985646,162,10896000,67259.25925925926,47,6063000
2022,county,48029,Bexar,42003,Allegheny,PA,Pittsburgh,100,4138000,41380.0,86,2794000,32488.372093023256,14,1344000
2022,county,48453,Travis,02020,Anchorage Borough,AK,Rural Alaska,47,3407000,72489.36170212766,37,1296000,35027.02702702703,10,2111000
2022,county,48029,Bexar,02020,Anchorage Borough,AK,Rural Alaska,239,6955000,29100.418410041842,156,6376000,40871.794871794875,83,579000
2022,county,48453,Travis,48005,Angelina,TX,Rural Texas,36,2746000,76277.77777777778,51,2192000,42980.39215686275,-15,554000
2022,county,48453,Travis,24003,Anne Arundel,MD,Baltimore,70,3536000,50514.28571428572,40,2891000,72275.0,30,645000
2022,county,48029,Bexar,24003,Anne Arundel,MD,Baltimore,342,13038000,38122.80701754386,230,8267000,35943.47826086957,112,4771000
2022,county,48453,Travis,48007,Aransas,TX,Rural Texas,33,1305000,39545.454545454544,87,5875000,67528.7356321839,-54,-4570000
2022,county,48029,Bexar,48007,Aransas,TX,Rural Texas,88,2328000,26454.545454545456,137,6196000,45226.277372262775,-49,-3868000
2022,county,48491,Williamson,08005,Arapahoe,CO,Denver,101,4048000,40079.207920792076,73,3884000,53205.479452054795,28,164000
2022,county,48453,Travis,08005,Arapahoe,CO,Denver,145,11376000,78455.1724137931,191,16848000,88209.42408376963,-46,-5472000
2022,county,48029,Bexar,08005,Arapahoe,CO,Denver,253,7918000,31296.442687747036,236,9049000,38343.220338983054,17,-1131000
2022,county,48453,Travis,51013,Arlington,VA,D.C.,136,12152000,89352.94117647059,70,6207000,88671.42857142857,66,5945000
2022,county,48029,Bexar,51013,Arlington,VA,D.C.,79,5017000,63506.329113924054,83,5145000,61987.951807228914,-4,-128000
2022,county,48029,Bexar,48013,Atascosa,TX,Rural Texas,1337,28404000,21244.57741211668,2216,47577000,21469.76534296029,-879,-19173000
2022,county,48453,Travis,24005,Baltimore,MD,Baltimore,59,3404000,57694.91525423729,42,3345000,79642.85714285714,17,59000
2022,county,48029,Bexar,24005,Baltimore,MD,Baltimore,66,3098000,46939.393939393936,60,2089000,34816.666666666664,6,1009000
2022,county,48453,Travis,24510,Baltimore city,MD,Baltimore,102,8332000,81686.27450980392,57,4791000,84052.63157894737,45,3541000
2022,county,48029,Bexar,24510,Baltimore city,MD,Baltimore,57,3646000,63964.912280701756,51,3035000,59509.80392156863,6,611000
2022,county,48029,Bexar,48019,Bandera,TX,Rural Texas,366,16819000,45953.551912568306,657,25437000,38716.89497716895,-291,-8618000
2022,county,48491,Williamson,48021,Bastrop,TX,Austin,506,14143000,27950.592885375496,705,27169000,38537.58865248227,-199,-13026000
2022,county,48453,Travis,48021,Bastrop,TX,Austin,1468,35280000,24032.697547683925,4298,135352000,31491.85667752443,-2830,-100072000
2022,county,48209,Hays,48021,Bastrop,TX,Austin,241,7578000,31443.983402489626,401,18472000,46064.837905236905,-160,-10894000
2022,county,48029,Bexar,48021,Bastrop,TX,Austin,135,4247000,31459.25925925926,119,3712000,31193.277310924368,16,535000
2022,county,48029,Bexar,12005,Bay,FL,FL Panhandle,64,1970000,30781.25,63,2444000,38793.65079365079,1,-474000
2022,county,48029,Bexar,48025,Bee,TX,Rural Texas,121,1999000,16520.661157024795,102,1751000,17166.666666666668,19,248000
2022,county,48491,Williamson,48027,Bell,TX,Rural Texas,1753,55016000,31383.913291500285,2980,104813000,35172.147651006715,-1227,-49797000
2022,county,48453,Travis,48027,Bell,TX,Rural Texas,1228,43873000,35727.1986970684,1925,74425000,38662.33766233766,-697,-30552000
2022,county,48209,Hays,48027,Bell,TX,Rural Texas,151,3567000,23622.51655629139,197,5771000,29294.41624365482,-46,-2204000
2022,county,48091,Comal,48027,Bell,TX,Rural Texas,121,3776000,31206.611570247933,75,2469000,32920.0,46,1307000
2022,county,48029,Bexar,48027,Bell,TX,Rural Texas,1077,25228000,23424.326833797586,719,16988000,23627.260083449237,358,8240000
2022,county,48491,Williamson,05007,Benton,AR,Rural Arkansas,72,5345000,74236.11111111111,78,3944000,50564.10256410256,-6,1401000
2022,county,48453,Travis,05007,Benton,AR,Rural Arkansas,77,8029000,104272.72727272728,119,9474000,79613.44537815126,-42,-1445000
2022,county,48029,Bexar,05007,Benton,AR,Rural Arkansas,60,4027000,67116.66666666667,75,3045000,40600.0,-15,982000
2022,county,48453,Travis,34003,Bergen,NJ,New York,155,12748000,82245.16129032258,43,2985000,69418.6046511628,112,9763000
2022,county,48029,Bexar,45015,Berkeley,SC,Charleston,85,2209000,25988.235294117647,76,1763000,23197.36842105263,9,446000
2022,county,48491,Williamson,35001,Bernalillo,NM,Albuquerque,111,5713000,51468.46846846847,61,3025000,49590.16393442623,50,2688000
2022,county,48453,Travis,35001,Bernalillo,NM,Albuquerque,145,8893000,61331.03448275862,173,11481000,66364.16184971099,-28,-2588000
2022,county,48029,Bexar,35001,Bernalillo,NM,Albuquerque,293,11559000,39450.51194539249,181,5948000,32861.87845303868,112,5611000
2022,county,48491,Williamson,48029,Bexar,TX,San Antonio,1090,50687000,46501.83486238532,1196,46972000,39274.247491638795,-106,3715000
2022,county,48453,Travis,48029,Bexar,TX,San Antonio,2618,229376000,87614.97326203209,2980,150532000,50514.093959731545,-362,78844000
2022,county,48209,Hays,48029,Bexar,TX,San Antonio,876,32605000,37220.3196347032,1034,32739000,31662.47582205029,-158,-134000
2022,county,48091,Comal,48029,Bexar,TX,San Antonio,4685,242734000,51810.88580576307,2625,127333000,48507.80952380953,2060,115401000
2022,county,48453,Travis,48031,Blanco,TX,Rural Texas,54,2323000,43018.51851851852,180,15174000,84300.0,-126,-12851000
2022,county,48209,Hays,48031,Blanco,TX,Rural Texas,59,2324000,39389.83050847457,180,18724000,104022.22222222222,-121,-16400000
2022,county,48091,Comal,48031,Blanco,TX,Rural Texas,105,5978000,56933.333333333336,112,10907000,97383.92857142857,-7,-4929000
2022,county,48029,Bexar,48031,Blanco,TX,Rural Texas,87,2963000,34057.471264367814,105,5915000,56333.333333333336,-18,-2952000
2022,county,48029,Bexar,22015,Bossier Parish,LA,Rural Louisiana,155,4522000,29174.1935483871,86,2709000,31500.0,69,1813000
2022,county,48453,Travis,08013,Boulder,CO,Denver,130,17978000,138292.3076923077,184,15954000,86706.52173913043,-54,2024000
2022,county,48029,Bexar,08013,Boulder,CO,Denver,36,1217000,33805.555555555555,56,2168000,38714.28571428572,-20,-951000
2022,county,48029,Bexar,48037,Bowie,TX,Rural Texas,43,662000,15395.348837209302,52,1580000,30384.615384615383,-9,-918000
2022,county,48491,Williamson,48039,Brazoria,TX,Houston,105,6295000,59952.380952380954,117,5866000,50136.75213675214,-12,429000
2022,county,48453,Travis,48039,Brazoria,TX,Houston,207,9102000,43971.014492753624,224,9724000,43410.71428571428,-17,-622000
2022,county,48209,Hays,48039,Brazoria,TX,Houston,58,2204000,38000.0,62,2431000,39209.67741935484,-4,-227000
2022,county,48091,Comal,48039,Brazoria,TX,Houston,82,5965000,72743.90243902439,47,1608000,34212.765957446805,35,4357000
2022,county,48029,Bexar,48039,Brazoria,TX,Houston,223,8671000,38883.408071748876,245,8131000,33187.755102040814,-22,540000
2022,county,48491,Williamson,48041,Brazos,TX,Rural Texas,246,10095000,41036.58536585366,294,10676000,36312.925170068025,-48,-581000
2022,county,48453,Travis,48041,Brazos,TX,Rural Texas,527,24305000,46119.54459203036,344,18107000,52636.62790697674,183,6198000
2022,county,48209,Hays,48041,Brazos,TX,Rural Texas,76,2736000,36000.0,75,5514000,73520.0,1,-2778000
2022,county,48091,Comal,48041,Brazos,TX,Rural Texas,73,3682000,50438.356164383564,52,2362000,45423.07692307692,21,1320000
2022,county,48029,Bexar,48041,Brazos,TX,Rural Texas,293,8901000,30378.839590443687,283,10433000,36865.72438162544,10,-1532000
2022,county,48453,Travis,12009,Brevard,FL,Atlantic Coast,62,2943000,47467.74193548387,50,3092000,61840.0,12,-149000
2022,county,48029,Bexar,12009,Brevard,FL,Atlantic Coast,127,3612000,28440.944881889765,136,5587000,41080.882352941175,-9,-1975000
2022,county,48453,Travis,08014,Broomfield,CO,Denver,32,4492000,140375.0,36,1937000,53805.555555555555,-4,2555000
2022,county,48491,Williamson,12011,Broward,FL,Miami,145,7359000,50751.724137931036,83,2949000,35530.12048192771,62,4410000
2022,county,48453,Travis,12011,Broward,FL,Miami,262,26753000,102110.68702290076,166,14099000,84933.73493975903,96,12654000
2022,county,48029,Bexar,12011,Broward,FL,Miami,242,9092000,37570.2479338843,120,4589000,38241.666666666664,122,4503000
2022,county,48453,Travis,42017,Bucks,PA,Philadelphia,67,4402000,65701.49253731343,29,1850000,63793.10344827586,38,2552000
2022,county,48453,Travis,37021,Buncombe,NC,Asheville,28,1771000,63250.0,129,11780000,91317.82945736434,-101,-10009000
2022,county,48029,Bexar,34005,Burlington,NJ,Philadelphia,124,3303000,26637.09677419355,95,2557000,26915.78947368421,29,746000
2022,county,48491,Williamson,48053,Burnet,TX,Rural Texas,485,19944000,41121.64948453608,1228,68352000,55661.23778501629,-743,-48408000
2022,county,48453,Travis,48053,Burnet,TX,Rural Texas,360,27124000,75344.44444444444,842,71804000,85277.90973871734,-482,-44680000
2022,county,48209,Hays,48053,Burnet,TX,Rural Texas,89,7035000,79044.94382022473,91,7137000,78428.57142857143,-2,-102000
2022,county,48091,Comal,48053,Burnet,TX,Rural Texas,51,2348000,46039.21568627451,46,5016000,109043.47826086957,5,-2668000
2022,county,48029,Bexar,48053,Burnet,TX,Rural Texas,65,2556000,39323.07692307692,149,25579000,171671.1409395973,-84,-23023000
2022,county,48029,Bexar,22017,Caddo Parish,LA,Rural Louisiana,53,3072000,57962.264150943396,49,1468000,29959.183673469386,4,1604000
2022,county,48453,Travis,22019,Calcasieu Parish,LA,Rural Louisiana,68,4110000,60441.17647058824,35,1034000,29542.85714285714,33,3076000
2022,county,48491,Williamson,48055,Caldwell,TX,Rural Texas,92,2552000,27739.130434782608,150,7260000,48400.0,-58,-4708000
2022,county,48453,Travis,48055,Caldwell,TX,Rural Texas,353,9866000,27949.00849858357,1118,30453000,27238.81932021467,-765,-20587000
2022,county,48209,Hays,48055,Caldwell,TX,Rural Texas,593,12845000,21661.045531197302,763,18879000,24743.119266055044,-170,-6034000
2022,county,48091,Comal,48055,Caldwell,TX,Rural Texas,51,1404000,27529.41176470588,53,1633000,30811.32075471698,-2,-229000
2022,county,48029,Bexar,48055,Caldwell,TX,Rural Texas,113,2610000,23097.34513274336,81,2585000,31913.58024691358,32,25000
2022,county,48491,Williamson,48061,Cameron,TX,Rural Texas,141,4576000,32453.90070921986,116,4954000,42706.89655172414,25,-378000
2022,county,48453,Travis,48061,Cameron,TX,Rural Texas,303,12613000,41627.062706270626,248,9891000,39883.06451612903,55,2722000
2022,county,48209,Hays,48061,Cameron,TX,Rural Texas,112,2288000,20428.571428571428,49,1224000,24979.591836734693,63,1064000
2022,county,48029,Bexar,48061,Cameron,TX,Rural Texas,889,25682000,28888.638920134985,601,16175000,26913.477537437604,288,9507000
2022,county,48491,Williamson,09110,Capitol,CT,Hartford,80,4573000,57162.5,50,2195000,43900.0,30,2378000
2022,county,48453,Travis,09110,Capitol,CT,Hartford,118,6559000,55584.745762711864,55,4170000,75818.18181818182,63,2389000
2022,county,48029,Bexar,09110,Capitol,CT,Hartford,103,3501000,33990.29126213592,55,4014000,72981.81818181818,48,-513000
2022,county,48029,Bexar,30013,Cascade,MT,Rural Montana,61,1887000,30934.426229508197,45,996000,22133.333333333332,16,891000
2022,county,48029,Bexar,24017,Charles,MD,Rural Maryland,41,1343000,32756.09756097561,46,1762000,38304.34782608696,-5,-419000
2022,county,48453,Travis,45019,Charleston,SC,Charleston,67,3211000,47925.37313432836,84,6649000,79154.76190476191,-17,-3438000
2022,county,48029,Bexar,45019,Charleston,SC,Charleston,99,4205000,42474.74747474748,57,4603000,80754.38596491228,42,-398000
2022,county,48453,Travis,13051,Chatham,GA,Savannah,42,2509000,59738.09523809524,41,1993000,48609.756097560974,1,516000
2022,county,48029,Bexar,13051,Chatham,GA,Savannah,64,1984000,31000.0,43,1520000,35348.83720930233,21,464000
2022,county,48029,Bexar,51550,Chesapeake city,VA,Hampton Roads,92,2783000,30250.0,53,1638000,30905.66037735849,39,1145000
2022,county,48453,Travis,42029,Chester,PA,Philadelphia,57,5338000,93649.12280701754,33,2255000,68333.33333333333,24,3083000
2022,county,48029,Bexar,51041,Chesterfield,VA,Richmond,64,2010000,31406.25,59,3084000,52271.186440677964,5,-1074000
2022,county,48453,Travis,50007,Chittenden,VT,Rural Vermont,31,3370000,108709.67741935483,44,2920000,66363.63636363637,-13,450000
2022,county,48453,Travis,41005,Clackamas,OR,Portland,75,12385000,165133.33333333334,43,4593000,106813.95348837209,32,7792000
2022,county,48491,Williamson,32003,Clark,NV,Las Vegas,294,9516000,32367.34693877551,134,6982000,52104.477611940296,160,2534000
2022,county,48491,Williamson,53011,Clark,WA,Portland,36,1829000,50805.555555555555,36,2893000,80361.11111111111,0,-1064000
2022,county,48453,Travis,32003,Clark,NV,Las Vegas,350,36530000,104371.42857142857,265,31355000,118320.75471698113,85,5175000
2022,county,48453,Travis,53011,Clark,WA,Portland,87,4169000,47919.54022988506,101,8224000,81425.74257425743,-14,-4055000
2022,county,48091,Comal,32003,Clark,NV,Las Vegas,102,3988000,39098.03921568627,49,1878000,38326.5306122449,53,2110000
2022,county,48029,Bexar,32003,Clark,NV,Las Vegas,828,28901000,34904.58937198068,609,19404000,31862.068965517243,219,9497000
2022,county,48029,Bexar,53011,Clark,WA,Portland,92,2777000,30184.782608695652,74,3252000,43945.94594594595,18,-475000
2022,county,48453,Travis,40027,Cleveland,OK,Oklahoma City,55,2346000,42654.545454545456,46,2148000,46695.65217391304,9,198000
2022,county,48029,Bexar,40027,Cleveland,OK,Oklahoma City,95,3258000,34294.73684210526,82,2261000,27573.170731707316,13,997000
2022,county,48491,Williamson,13067,Cobb,GA,Atlanta,61,2957000,48475.40983606558,61,2903000,47590.16393442623,0,54000
2022,county,48453,Travis,13067,Cobb,GA,Atlanta,104,6977000,67086.53846153847,117,8151000,69666.66666666667,-13,-1174000
2022,county,48029,Bexar,13067,Cobb,GA,Atlanta,65,2503000,38507.692307692305,92,3243000,35250.0,-27,-740000
2022,county,48029,Bexar,04003,Cochise,AZ,Rural Arizona,106,2893000,27292.45283018868,66,1265000,19166.666666666668,40,1628000
2022,county,48453,Travis,12021,Collier,FL,S.W. Florida,59,8660000,146779.66101694916,77,8944000,116155.84415584416,-18,-284000
2022,county,48029,Bexar,12021,Collier,FL,S.W. Florida,36,1905000,52916.666666666664,38,1510000,39736.84210526316,-2,395000
2022,county,48491,Williamson,48085,Collin,TX,Dallas-Fort Worth,608,44758000,73615.13157894737,570,33655000,59043.85964912281,38,11103000
2022,county,48453,Travis,48085,Collin,TX,Dallas-Fort Worth,971,76201000,78476.8280123584,990,84486000,85339.39393939394,-19,-8285000
2022,county,48209,Hays,48085,Collin,TX,Dallas-Fort Worth,158,13465000,85221.51898734177,129,5564000,43131.782945736435,29,7901000
2022,county,48091,Comal,48085,Collin,TX,Dallas-Fort Worth,141,8818000,62539.00709219858,41,2911000,71000.0,100,5907000
2022,county,48029,Bexar,48085,Collin,TX,Dallas-Fort Worth,563,26085000,46332.14920071048,755,40148000,53176.15894039735,-192,-14063000
2022,county,48029,Bexar,13073,Columbia,GA,Augusta,104,3236000,31115.384615384617,136,3625000,26654.41176470588,-32,-389000
2022,county,48491,Williamson,48091,Comal,TX,San Antonio,182,8133000,44686.81318681319,502,26415000,52619.521912350596,-320,-18282000
2022,county,48453,Travis,48091,Comal,TX,San Antonio,352,17794000,50551.13636363636,1112,73056000,65697.8417266187,-760,-55262000
2022,county,48209,Hays,48091,Comal,TX,San Antonio,649,31595000,48682.588597842834,1239,84662000,68330.91202582727,-590,-53067000
2022,county,48029,Bexar,48091,Comal,TX,San Antonio,2625,127333000,48507.80952380953,4685,242734000,51810.88580576307,-2060,-115401000
2022,county,48029,Bexar,40031,Comanche,OK,Rural Oklahoma,109,2217000,20339.449541284404,69,1551000,22478.260869565216,40,666000
2022,county,48491,Williamson,06013,Contra Costa,CA,Bay Area,244,20226000,82893.44262295082,52,4500000,86538.46153846153,192,15726000
2022,county,48453,Travis,06013,Contra Costa,CA,Bay Area,336,78775000,234449.40476190476,102,9669000,94794.11764705883,234,69106000
2022,county,48029,Bexar,06013,Contra Costa,CA,Bay Area,128,8796000,68718.75,44,3390000,77045.45454545454,84,5406000
2022,county,48491,Williamson,17031,Cook,IL,Chicago,460,61843000,134441.30434782608,161,8852000,54981.36645962733,299,52991000
2022,county,48453,Travis,17031,Cook,IL,Chicago,1276,189041000,148151.2539184953,647,82423000,127392.58114374035,629,106618000
2022,county,48209,Hays,17031,Cook,IL,Chicago,116,8095000,69784.4827586207,31,1394000,44967.74193548387,85,6701000
2022,county,48029,Bexar,17031,Cook,IL,Chicago,663,25209000,38022.62443438914,314,13096000,41707.00636942675,349,12113000
2022,county,48491,Williamson,48099,Coryell,TX,Rural Texas,194,5201000,26809.278350515466,273,8125000,29761.904761904763,-79,-2924000
2022,county,48453,Travis,48099,Coryell,TX,Rural Texas,155,3266000,21070.967741935485,180,6851000,38061.11111111111,-25,-3585000
2022,county,48029,Bexar,48099,Coryell,TX,Rural Texas,268,4672000,17432.83582089552,164,2935000,17896.341463414636,104,1737000
2022,county,48453,Travis,37051,Cumberland,NC,Rural North Carolina,57,1716000,30105.263157894737,34,1166000,34294.117647058825,23,550000
2022,county,48453,Travis,23005,Cumberland,ME,Portland,29,1563000,53896.55172413793,75,4241000,56546.666666666664,-46,-2678000
2022,county,48029,Bexar,37051,Cumberland,NC,Rural North Carolina,372,8785000,23615.59139784946,236,6571000,27843.22033898305,136,2214000
2022,county,48029,Bexar,35009,Curry,NM,Rural New Mexico,62,1701000,27435.483870967742,45,1531000,34022.22222222222,17,170000
2022,county,48453,Travis,39035,Cuyahoga,OH,Cleveland,140,8128000,58057.142857142855,84,4435000,52797.619047619046,56,3693000
2022,county,48029,Bexar,39035,Cuyahoga,OH,Cleveland,62,2357000,38016.12903225807,87,3593000,41298.85057471264,-25,-1236000
2022,county,48491,Williamson,48113,Dallas,TX,Dallas-Fort Worth,752,53798000,71539.89361702128,545,25700000,47155.963302752294,207,28098000
2022,county,48453,Travis,48113,Dallas,TX,Dallas-Fort Worth,2222,198801000,89469.39693969396,1878,164630000,87662.40681576145,344,34171000
2022,county,48209,Hays,48113,Dallas,TX,Dallas-Fort Worth,298,22639000,75969.79865771811,198,7819000,39489.89898989899,100,14820000
2022,county,48091,Comal,48113,Dallas,TX,Dallas-Fort Worth,138,12241000,88702.89855072464,78,4375000,56089.743589743586,60,7866000
2022,county,48029,Bexar,48113,Dallas,TX,Dallas-Fort Worth,1270,52717000,41509.44881889764,1330,61195000,46011.278195488725,-60,-8478000
2022,county,48453,Travis,55025,Dane,WI,Madison,142,11285000,79471.8309859155,108,5692000,52703.7037037037,34,5593000
2022,county,48029,Bexar,55025,Dane,WI,Madison,59,2890000,48983.05084745763,46,2841000,61760.86956521739,13,49000
2022,county,48491,Williamson,47037,Davidson,TN,Nashville,47,2449000,52106.382978723406,43,2625000,61046.51162790698,4,-176000
2022,county,48453,Travis,47037,Davidson,TN,Nashville,195,17779000,91174.35897435897,254,34680000,136535.43307086613,-59,-16901000
2022,county,48029,Bexar,47037,Davidson,TN,Nashville,112,5377000,48008.92857142857,103,5407000,52495.145631067964,9,-30000
2022,county,48029,Bexar,49011,Davis,UT,Rural Utah,121,3383000,27958.677685950413,134,3605000,26902.985074626864,-13,-222000
2022,county,48491,Williamson,13089,DeKalb,GA,Atlanta,45,2785000,61888.88888888889,38,2435000,64078.94736842105,7,350000
2022,county,48453,Travis,13089,DeKalb,GA,Atlanta,117,9312000,79589.7435897436,110,9208000,83709.09090909091,7,104000
2022,county,48029,Bexar,13089,DeKalb,GA,Atlanta,78,3701000,47448.717948717946,68,3630000,53382.35294117647,10,71000
2022,county,48029,Bexar,48123,DeWitt,TX,Rural Texas,43,602000,14000.0,69,1289000,18681.159420289856,-26,-687000
2022,county,48491,Williamson,48121,Denton,TX,Dallas-Fort Worth,408,29775000,72977.94117647059,439,22922000,52214.12300683371,-31,6853000
2022,county,48453,Travis,48121,Denton,TX,Dallas-Fort Worth,701,65129000,92908.70185449359,699,39704000,56801.144492131614,2,25425000
2022,county,48209,Hays,48121,Denton,TX,Dallas-Fort Worth,138,6322000,45811.59420289855,129,4848000,37581.395348837206,9,1474000
2022,county,48091,Comal,48121,Denton,TX,Dallas-Fort Worth,93,6774000,72838.70967741935,86,4435000,51569.767441860466,7,2339000
2022,county,48029,Bexar,48121,Denton,TX,Dallas-Fort Worth,531,26180000,49303.20150659134,648,28088000,43345.67901234568,-117,-1908000
2022,county,48491,Williamson,08031,Denver,CO,Denver,112,7255000,64776.78571428572,89,4883000,54865.168539325845,23,2372000
2022,county,48453,Travis,08031,Denver,CO,Denver,391,28308000,72398.97698209719,560,85024000,151828.57142857142,-169,-56716000
2022,county,48209,Hays,08031,Denver,CO,Denver,32,1900000,59375.0,34,1971000,57970.58823529412,-2,-71000
2022,county,48029,Bexar,08031,Denver,CO,Denver,181,8111000,44812.154696132595,220,15649000,71131.81818181818,-39,-7538000
2022,county,48453,Travis,41017,Deschutes,OR,Rural Oregon,29,1051000,36241.379310344826,57,6290000,110350.87719298246,-28,-5239000
2022,county,48453,Travis,11001,District of Columbia,DC,D.C.,263,45537000,173144.4866920152,238,22317000,93768.9075630252,25,23220000
2022,county,48029,Bexar,11001,District of Columbia,DC,D.C.,100,6953000,69530.0,115,6368000,55373.913043478264,-15,585000
2022,county,48453,Travis,35013,Dona Ana,NM,Rural New Mexico,60,1982000,33033.333333333336,49,1554000,31714.285714285714,11,428000
2022,county,48029,Bexar,35013,Dona Ana,NM,Rural New Mexico,122,4178000,34245.901639344265,103,3530000,34271.844660194176,19,648000
2022,county,48491,Williamson,08035,Douglas,CO,Denver,93,5173000,55623.655913978495,119,7987000,67117.64705882352,-26,-2814000
2022,county,48453,Travis,08035,Douglas,CO,Denver,119,7721000,64882.35294117647,151,12293000,81410.59602649006,-32,-4572000
2022,county,48453,Travis,31055,Douglas,NE,Omaha,102,11353000,111303.92156862745,75,2896000,38613.333333333336,27,8457000
2022,county,48029,Bexar,31055,Douglas,NE,Omaha,114,4329000,37973.68421052631,81,3417000,42185.18518518518,33,912000
2022,county,48029,Bexar,08035,Douglas,CO,Denver,107,4230000,39532.71028037383,97,6599000,68030.92783505155,10,-2369000
2022,county,48491,Williamson,17043,DuPage,IL,Chicago,133,7986000,60045.112781954886,33,1573000,47666.666666666664,100,6413000
2022,county,48453,Travis,17043,DuPage,IL,Chicago,178,16007000,89926.96629213484,69,5752000,83362.31884057971,109,10255000
2022,county,48029,Bexar,17043,DuPage,IL,Chicago,115,6164000,53600.0,49,1959000,39979.5918367347,66,4205000
2022,county,48453,Travis,37063,Durham,NC,Raleigh,87,5812000,66804.59770114943,76,4315000,56776.31578947369,11,1497000
2022,county,48029,Bexar,37063,Durham,NC,Raleigh,39,1974000,50615.38461538462,50,2238000,44760.0,-11,-264000
2022,county,48491,Williamson,12031,Duval,FL,Jacksonville,62,2653000,42790.32258064516,40,2042000,51050.0,22,611000
2022,county,48453,Travis,12031,Duval,FL,Jacksonville,121,5181000,42818.181818181816,106,5399000,50933.96226415094,15,-218000
2022,county,48029,Bexar,12031,Duval,FL,Jacksonville,183,5852000,31978.142076502732,195,6346000,32543.589743589742,-12,-494000
2022,county,48453,Travis,22033,East Baton Rouge Parish,LA,Rural Louisiana,148,6861000,46358.10810810811,69,3378000,48956.52173913043,79,3483000
2022,county,48029,Bexar,22033,East Baton Rouge Parish,LA,Rural Louisiana,74,2215000,29932.432432432433,47,1464000,31148.936170212764,27,751000
2022,county,48491,Williamson,48135,Ector,TX,Rural Texas,76,4167000,54828.94736842105,39,1600000,41025.64102564102,37,2567000
2022,county,48453,Travis,48135,Ector,TX,Rural Texas,78,3133000,40166.666666666664,60,1304000,21733.333333333332,18,1829000
2022,county,48029,Bexar,48135,Ector,TX,Rural Texas,287,7594000,26459.93031358885,171,3530000,20643.27485380117,116,4064000
2022,county,48491,Williamson,48141,El Paso,TX,El Paso,277,9852000,35566.78700361011,191,7403000,38759.16230366492,86,2449000
2022,county,48491,Williamson,08041,El Paso,CO,Colorado Springs,161,5764000,35801.242236024846,190,9633000,50700.0,-29,-3869000
2022,county,48453,Travis,48141,El Paso,TX,El Paso,573,19271000,33631.76265270506,356,14720000,41348.31460674157,217,4551000
2022,county,48453,Travis,08041,El Paso,CO,Colorado Springs,167,6482000,38814.37125748503,275,15273000,55538.181818181816,-108,-8791000
2022,county,48209,Hays,48141,El Paso,TX,El Paso,93,2370000,25483.870967741936,58,3049000,52568.96551724138,35,-679000
2022,county,48209,Hays,08041,El Paso,CO,Colorado Springs,61,2519000,41295.08196721312,55,1726000,31381.81818181818,6,793000
2022,county,48091,Comal,48141,El Paso,TX,El Paso,94,3606000,38361.70212765958,34,1260000,37058.82352941176,60,2346000
2022,county,48091,Comal,08041,El Paso,CO,Colorado Springs,66,2370000,35909.09090909091,57,1351000,23701.754385964912,9,1019000
2022,county,48029,Bexar,48141,El Paso,TX,El Paso,1554,41820000,26911.196911196912,936,25169000,26889.957264957266,618,16651000
2022,county,48029,Bexar,08041,El Paso,CO,Colorado Springs,839,24970000,29761.620977353992,801,30588000,38187.265917603,38,-5618000
2022,county,48491,Williamson,48139,Ellis,TX,Dallas-Fort Worth,69,2084000,30202.898550724636,118,4999000,42364.40677966102,-49,-2915000
2022,county,48453,Travis,48139,Ellis,TX,Dallas-Fort Worth,66,2430000,36818.181818181816,76,3201000,42118.42105263158,-10,-771000
2022,county,48029,Bexar,48139,Ellis,TX,Dallas-Fort Worth,76,2773000,36486.84210526316,99,3559000,35949.49494949495,-23,-786000
2022,county,48453,Travis,36029,Erie,NY,Buffalo,87,5873000,67505.74712643678,41,2472000,60292.68292682927,46,3401000
2022,county,48029,Bexar,12033,Escambia,FL,FL Panhandle,137,3453000,25204.379562043796,133,3863000,29045.112781954886,4,-410000
2022,county,48453,Travis,25009,Essex,MA,Boston,78,7604000,97487.17948717948,67,5116000,76358.20895522388,11,2488000
2022,county,48453,Travis,34013,Essex,NJ,New York,68,5135000,75514.70588235294,54,3979000,73685.18518518518,14,1156000
2022,county,48029,Bexar,02090,Fairbanks North Star Borough,AK,Rural Alaska,118,3749000,31771.186440677968,66,1820000,27575.757575757576,52,1929000
2022,county,48491,Williamson,51059,Fairfax,VA,D.C.,137,9529000,69554.74452554744,54,3407000,63092.59259259259,83,6122000
2022,county,48453,Travis,51059,Fairfax,VA,D.C.,238,19821000,83281.51260504202,135,9451000,70007.4074074074,103,10370000
2022,county,48029,Bexar,51059,Fairfax,VA,D.C.,477,21897000,45905.660377358494,422,21005000,49774.88151658768,55,892000
2022,county,48453,Travis,48149,Fayette,TX,Rural Texas,52,2092000,40230.769230769234,98,4982000,50836.73469387755,-46,-2890000
2022,county,48453,Travis,21067,Fayette,KY,Lexington,29,1580000,54482.75862068965,33,1680000,50909.09090909091,-4,-100000
2022,county,48453,Travis,37067,Forsyth,NC,Greensboro,27,2195000,81296.29629629629,37,2184000,59027.02702702703,-10,11000
2022,county,48029,Bexar,37067,Forsyth,NC,Greensboro,51,1570000,30784.313725490196,63,2062000,32730.15873015873,-12,-492000
2022,county,48491,Williamson,48157,Fort Bend,TX,Houston,397,22494000,56659.94962216625,332,16059000,48370.48192771084,65,6435000
2022,county,48453,Travis,48157,Fort Bend,TX,Houston,805,68133000,84637.26708074534,689,38996000,56597.96806966618,116,29137000
2022,county,48209,Hays,48157,Fort Bend,TX,Houston,154,12585000,81720.77922077922,104,6540000,62884.61538461538,50,6045000
2022,county,48091,Comal,48157,Fort Bend,TX,Houston,177,13652000,77129.94350282486,71,4291000,60436.619718309856,106,9361000
2022,county,48029,Bexar,48157,Fort Bend,TX,Houston,538,21624000,40193.30855018587,637,27327000,42899.52904238619,-99,-5703000
2022,county,48491,Williamson,39049,Franklin,OH,Columbus,115,5649000,49121.739130434784,35,2054000,58685.71428571428,80,3595000
2022,county,48453,Travis,39049,Franklin,OH,Columbus,207,12665000,61183.57487922705,104,7104000,68307.69230769231,103,5561000
2022,county,48029,Bexar,39049,Franklin,OH,Columbus,198,6302000,31828.282828282827,119,3700000,31092.436974789915,79,2602000
2022,county,48029,Bexar,24021,Frederick,MD,Rural Maryland,50,2145000,42900.0,87,2615000,30057.471264367818,-37,-470000
2022,county,48029,Bexar,06019,Fresno,CA,Fresno,131,5425000,41412.21374045801,49,1010000,20612.244897959183,82,4415000
2022,county,48029,Bexar,48163,Frio,TX,Rural Texas,205,5526000,26956.09756097561,208,4729000,22735.576923076922,-3,797000
2022,county,48491,Williamson,13121,Fulton,GA,Atlanta,80,3802000,47525.0,50,2662000,53240.0,30,1140000
2022,county,48453,Travis,13121,Fulton,GA,Atlanta,279,32105000,115071.68458781362,228,16970000,74429.82456140351,51,15135000
2022,county,48029,Bexar,13121,Fulton,GA,Atlanta,135,7641000,56600.0,117,4806000,41076.92307692308,18,2835000
2022,county,48453,Travis,30031,Gallatin,MT,Rural Montana,31,1113000,35903.22580645161,38,2024000,53263.15789473684,-7,-911000
2022,county,48491,Williamson,48167,Galveston,TX,Houston,159,7327000,46081.76100628931,139,6683000,48079.13669064748,20,644000
2022,county,48453,Travis,48167,Galveston,TX,Houston,268,10928000,40776.119402985074,294,17695000,60187.074829931975,-26,-6767000
2022,county,48209,Hays,48167,Galveston,TX,Houston,81,3035000,37469.135802469136,73,2686000,36794.520547945205,8,349000
2022,county,48091,Comal,48167,Galveston,TX,Houston,128,9647000,75367.1875,55,3777000,68672.72727272728,73,5870000
2022,county,48029,Bexar,48167,Galveston,TX,Houston,197,7288000,36994.92385786802,218,9423000,43224.77064220184,-21,-2135000
2022,county,48029,Bexar,20061,Geary,KS,Rural Kansas,75,1530000,20400.0,114,2045000,17938.59649122807,-39,-515000
2022,county,48491,Williamson,48171,Gillespie,TX,Rural Texas,36,1268000,35222.22222222222,63,5739000,91095.23809523809,-27,-4471000
2022,county,48453,Travis,48171,Gillespie,TX,Rural Texas,50,3335000,66700.0,118,13340000,113050.84745762713,-68,-10005000
2022,county,48029,Bexar,48171,Gillespie,TX,Rural Texas,130,7422000,57092.307692307695,138,15454000,111985.50724637682,-8,-8032000
2022,county,48029,Bexar,48177,Gonzales,TX,Rural Texas,61,1388000,22754.09836065574,64,1804000,28187.5,-3,-416000
2022,county,48453,Travis,48181,Grayson,TX,Rural Texas,37,1743000,47108.10810810811,27,1227000,45444.444444444445,10,516000
2022,county,48029,Bexar,48181,Grayson,TX,Rural Texas,41,1073000,26170.731707317074,45,1334000,29644.444444444445,-4,-261000
2022,county,48029,Bexar,39057,Greene,OH,Rural Ohio,106,4521000,42650.943396226416,66,2481000,37590.90909090909,40,2040000
2022,county,48453,Travis,45045,Greenville,SC,Greenville,49,2398000,48938.77551020408,67,4204000,62746.26865671642,-18,-1806000
2022,county,48029,Bexar,45045,Greenville,SC,Greenville,43,1778000,41348.83720930233,64,3043000,47546.875,-21,-1265000
2022,county,48491,Williamson,48183,Gregg,TX,Rural Texas,33,1471000,44575.757575757576,54,2228000,41259.25925925926,-21,-757000
2022,county,48453,Travis,48183,Gregg,TX,Rural Texas,53,1746000,32943.3962264151,70,3236000,46228.57142857143,-17,-1490000
2022,county,48029,Bexar,48183,Gregg,TX,Rural Texas,47,1445000,30744.68085106383,50,1366000,27320.0,-3,79000
2022,county,48491,Williamson,48187,Guadalupe,TX,San Antonio,129,4266000,33069.767441860466,280,11701000,41789.28571428572,-151,-7435000
2022,county,48453,Travis,48187,Guadalupe,TX,San Antonio,231,15779000,68307.35930735931,667,27033000,40529.23538230885,-436,-11254000
2022,county,48209,Hays,48187,Guadalupe,TX,San Antonio,598,15313000,25607.023411371236,1140,35146000,30829.824561403508,-542,-19833000
2022,county,48091,Comal,48187,Guadalupe,TX,San Antonio,2499,118927000,47589.83593437375,2461,88849000,36102.80373831776,38,30078000
2022,county,48029,Bexar,48187,Guadalupe,TX,San Antonio,3753,115884000,30877.69784172662,4593,138453000,30144.35009797518,-840,-22569000
2022,county,48453,Travis,37081,Guilford,NC,Greensboro,51,1990000,39019.60784313725,56,2121000,37875.0,-5,-131000
2022,county,48029,Bexar,37081,Guilford,NC,Greensboro,42,1478000,35190.47619047619,31,899000,29000.0,11,579000
2022,county,48491,Williamson,13135,Gwinnett,GA,Atlanta,64,1971000,30796.875,52,2308000,44384.61538461538,12,-337000
2022,county,48453,Travis,13135,Gwinnett,GA,Atlanta,90,4216000,46844.444444444445,94,4202000,44702.12765957447,-4,14000
2022,county,48029,Bexar,13135,Gwinnett,GA,Atlanta,87,2607000,29965.51724137931,102,3255000,31911.764705882353,-15,-648000
2022,county,48453,Travis,39061,Hamilton,OH,Cincinnati,97,5975000,61597.9381443299,82,6106000,74463.41463414633,15,-131000
2022,county,48453,Travis,18057,Hamilton,IN,Indianapolis,71,3858000,54338.028169014084,42,3911000,93119.04761904762,29,-53000
2022,county,48453,Travis,47065,Hamilton,TN,Chattanooga,58,2615000,45086.206896551725,67,3902000,58238.80597014925,-9,-1287000
2022,county,48029,Bexar,39061,Hamilton,OH,Cincinnati,80,5039000,62987.5,61,3533000,57918.03278688525,19,1506000
2022,county,48029,Bexar,47065,Hamilton,TN,Chattanooga,40,1647000,41175.0,50,1569000,31380.0,-10,78000
2022,county,48029,Bexar,51650,Hampton city,VA,Hampton Roads,91,2690000,29560.43956043956,70,2391000,34157.142857142855,21,299000
2022,county,48029,Bexar,37085,Harnett,NC,Rural North Carolina,78,2098000,26897.4358974359,104,2199000,21144.23076923077,-26,-101000
2022,county,48491,Williamson,48201,Harris,TX,Houston,1590,81270000,51113.20754716981,1210,55003000,45457.02479338843,380,26267000
2022,county,48453,Travis,48201,Harris,TX,Houston,4265,328727000,77075.49824150058,3429,222725000,64953.33916593759,836,106002000
2022,county,48209,Hays,48201,Harris,TX,Houston,691,42246000,61137.48191027496,488,17021000,34879.098360655735,203,25225000
2022,county,48091,Comal,48201,Harris,TX,Houston,664,77649000,116941.26506024097,283,13435000,47473.49823321555,381,64214000
2022,county,48029,Bexar,48201,Harris,TX,Houston,2905,126788000,43644.750430292595,3047,112939000,37065.638332786344,-142,13849000
2022,county,48029,Bexar,28047,Harrison,MS,Gulfport-Biloxi,168,5007000,29803.571428571428,166,4810000,28975.90361445783,2,197000
2022,county,48491,Williamson,48209,Hays,TX,Austin,783,34687000,44300.12771392082,1119,48608000,43438.78462913315,-336,-13921000
2022,county,48453,Travis,48209,Hays,TX,Austin,3587,178199000,49679.11904098132,9886,696238000,70426.66396924945,-6299,-518039000
2022,county,48091,Comal,48209,Hays,TX,Austin,1239,84662000,68330.91202582727,649,31595000,48682.588597842834,590,53067000
2022,county,48029,Bexar,48209,Hays,TX,Austin,1034,32739000,31662.47582205029,876,32605000,37220.3196347032,158,134000
2022,county,48491,Williamson,27053,Hennepin,MN,Minneapolis,198,13610000,68737.37373737374,45,1770000,39333.333333333336,153,11840000
2022,county,48453,Travis,27053,Hennepin,MN,Minneapolis,341,42301000,124049.85337243402,161,22849000,141919.2546583851,180,19452000
2022,county,48029,Bexar,27053,Hennepin,MN,Minneapolis,120,9360000,78000.0,78,2727000,34961.53846153846,42,6633000
2022,county,48453,Travis,51087,Henrico,VA,Richmond,44,2659000,60431.818181818184,47,2482000,52808.51063829787,-3,177000
2022,county,48491,Williamson,48215,Hidalgo,TX,Rural Texas,241,6035000,25041.49377593361,140,5044000,36028.57142857143,101,991000
2022,county,48453,Travis,48215,Hidalgo,TX,Rural Texas,517,19629000,37967.11798839458,407,15093000,37083.538083538086,110,4536000
2022,county,48209,Hays,48215,Hidalgo,TX,Rural Texas,120,3496000,29133.333333333332,86,2236000,26000.0,34,1260000
2022,county,48091,Comal,48215,Hidalgo,TX,Rural Texas,69,3114000,45130.434782608696,50,1350000,27000.0,19,1764000
2022,county,48029,Bexar,48215,Hidalgo,TX,Rural Texas,1487,77176000,51900.4707464694,1029,26856000,26099.125364431486,458,50320000
2022,county,48491,Williamson,12057,Hillsborough,FL,Tampa,96,4045000,42135.416666666664,136,6029000,44330.882352941175,-40,-1984000
2022,county,48453,Travis,12057,Hillsborough,FL,Tampa,198,10057000,50792.92929292929,198,13120000,66262.62626262626,0,-3063000
2022,county,48029,Bexar,12057,Hillsborough,FL,Tampa,299,10662000,35658.86287625418,304,12069000,39700.65789473684,-5,-1407000
2022,county,48491,Williamson,15003,Honolulu,HI,Rural Hawaii,138,6876000,49826.086956521736,61,2500000,40983.60655737705,77,4376000
2022,county,48453,Travis,15003,Honolulu,HI,Rural Hawaii,139,7596000,54647.482014388486,82,7035000,85792.68292682926,57,561000
2022,county,48029,Bexar,15003,Honolulu,HI,Rural Hawaii,776,25268000,32561.855670103094,492,14934000,30353.658536585364,284,10334000
2022,county,48453,Travis,48221,Hood,TX,Rural Texas,29,2113000,72862.06896551725,38,4061000,106868.42105263157,-9,-1948000
2022,county,48029,Bexar,13153,Houston,GA,Rural Georgia,107,2442000,22822.429906542056,65,2682000,41261.53846153846,42,-240000
2022,county,48029,Bexar,24027,Howard,MD,Baltimore,71,3378000,47577.464788732395,63,3783000,60047.619047619046,8,-405000
2022,county,48453,Travis,34017,Hudson,NJ,New York,233,20771000,89145.92274678111,97,9960000,102680.41237113402,136,10811000
2022,county,48029,Bexar,48231,Hunt,TX,Dallas-Fort Worth,43,1257000,29232.558139534885,82,1886000,23000.0,-39,-629000
2022,county,48453,Travis,26065,Ingham,MI,Rural Michigan,34,1323000,38911.76470588235,25,1309000,52360.0,9,14000
2022,county,48491,Williamson,29095,Jackson,MO,Kansas City,40,1478000,36950.0,49,1867000,38102.04081632653,-9,-389000
2022,county,48453,Travis,29095,Jackson,MO,Kansas City,109,6560000,60183.48623853211,87,5556000,63862.06896551724,22,1004000
2022,county,48029,Bexar,29095,Jackson,MO,Kansas City,96,3275000,34114.583333333336,94,3455000,36755.31914893617,2,-180000
2022,county,48029,Bexar,28059,Jackson,MS,Gulfport-Biloxi,33,1540000,46666.666666666664,67,2456000,36656.71641791045,-34,-916000
2022,county,48491,Williamson,48245,Jefferson,TX,Rural Texas,86,4234000,49232.558139534885,53,2510000,47358.49056603773,33,1724000
2022,county,48491,Williamson,08059,Jefferson,CO,Denver,89,5378000,60426.96629213483,73,4810000,65890.4109589041,16,568000
2022,county,48453,Travis,48245,Jefferson,TX,Rural Texas,168,7245000,43125.0,124,5265000,42459.67741935484,44,1980000
2022,county,48453,Travis,08059,Jefferson,CO,Denver,130,7318000,56292.307692307695,241,19720000,81825.72614107883,-111,-12402000
2022,county,48453,Travis,21111,Jefferson,KY,Louisville,68,4080000,60000.0,79,5379000,68088.60759493671,-11,-1299000
2022,county,48029,Bexar,48245,Jefferson,TX,Rural Texas,159,3311000,20823.899371069183,103,3304000,32077.66990291262,56,7000
2022,county,48029,Bexar,08059,Jefferson,CO,Denver,123,4972000,40422.76422764228,90,7139000,79322.22222222222,33,-2167000
2022,county,48029,Bexar,36045,Jefferson,NY,Rural New York,133,2913000,21902.255639097744,59,1243000,21067.79661016949,74,1670000
2022,county,48029,Bexar,01073,Jefferson,AL,Birmingham,87,4099000,47114.942528735635,69,3587000,51985.50724637681,18,512000
2022,county,48029,Bexar,21111,Jefferson,KY,Louisville,81,2765000,34135.8024691358,94,2914000,31000.0,-13,-149000
2022,county,48453,Travis,22051,Jefferson Parish,LA,New Orleans,103,4162000,40407.76699029126,41,1515000,36951.21951219512,62,2647000
2022,county,48029,Bexar,22051,Jefferson Parish,LA,New Orleans,90,2932000,32577.777777777777,40,1144000,28600.0,50,1788000
2022,county,48029,Bexar,48249,Jim Wells,TX,Rural Texas,135,3043000,22540.74074074074,115,2653000,23069.565217391304,20,390000
2022,county,48491,Williamson,20091,Johnson,KS,Kansas City,154,10709000,69538.96103896105,72,3809000,52902.77777777778,82,6900000
2022,county,48491,Williamson,48251,Johnson,TX,Dallas-Fort Worth,41,1984000,48390.243902439026,72,3366000,46750.0,-31,-1382000
2022,county,48453,Travis,20091,Johnson,KS,Kansas City,167,17387000,104113.77245508983,83,5164000,62216.867469879515,84,12223000
2022,county,48453,Travis,48251,Johnson,TX,Dallas-Fort Worth,54,2673000,49500.0,83,2926000,35253.01204819277,-29,-253000
2022,county,48029,Bexar,20091,Johnson,KS,Kansas City,83,5120000,61686.74698795181,102,5405000,52990.19607843137,-19,-285000
2022,county,48029,Bexar,48251,Johnson,TX,Dallas-Fort Worth,55,1287000,23400.0,125,4477000,35816.0,-70,-3190000
2022,county,48029,Bexar,29101,Johnson,MO,Rural Missouri,45,1140000,25333.333333333332,40,1224000,30600.0,5,-84000
2022,county,48453,Travis,17089,Kane,IL,Chicago,55,2558000,46509.09090909091,34,1533000,45088.23529411765,21,1025000
2022,county,48029,Bexar,17089,Kane,IL,Chicago,80,3453000,43162.5,38,1063000,27973.684210526317,42,2390000
2022,county,48029,Bexar,48255,Karnes,TX,Rural Texas,78,2629000,33705.1282051282,89,2874000,32292.134831460673,-11,-245000
2022,county,48491,Williamson,48257,Kaufman,TX,Dallas-Fort Worth,35,1678000,47942.857142857145,67,3233000,48253.73134328358,-32,-1555000
2022,county,48453,Travis,48257,Kaufman,TX,Dallas-Fort Worth,48,1581000,32937.5,104,3651000,35105.769230769234,-56,-2070000
2022,county,48029,Bexar,48257,Kaufman,TX,Dallas-Fort Worth,65,2655000,40846.153846153844,93,2841000,30548.387096774193,-28,-186000
2022,county,48453,Travis,48259,Kendall,TX,Rural Texas,91,5751000,63197.8021978022,115,11953000,103939.13043478261,-24,-6202000
2022,county,48091,Comal,48259,Kendall,TX,Rural Texas,224,14494000,64705.357142857145,166,8065000,48584.33734939759,58,6429000
2022,county,48029,Bexar,48259,Kendall,TX,Rural Texas,980,50805000,51841.836734693876,2099,145309000,69227.72748928062,-1119,-94504000
2022,county,48453,Travis,26081,Kent,MI,Rural Michigan,65,4990000,76769.23076923077,69,5104000,73971.01449275362,-4,-114000
2022,county,48029,Bexar,26081,Kent,MI,Rural Michigan,64,1599000,24984.375,53,2837000,53528.301886792455,11,-1238000
2022,county,48029,Bexar,10001,Kent,DE,Rural Delaware,81,2062000,25456.79012345679,43,1065000,24767.441860465115,38,997000
2022,county,48029,Bexar,06029,Kern,CA,Rural California,223,6412000,28753.363228699553,87,2184000,25103.44827586207,136,4228000
2022,county,48491,Williamson,48265,Kerr,TX,Rural Texas,44,1519000,34522.72727272727,69,5150000,74637.68115942029,-25,-3631000
2022,county,48453,Travis,48265,Kerr,TX,Rural Texas,73,3329000,45602.739726027394,147,10238000,69646.25850340136,-74,-6909000
2022,county,48091,Comal,48265,Kerr,TX,Rural Texas,39,770000,19743.589743589742,62,1921000,30983.870967741936,-23,-1151000
2022,county,48029,Bexar,48265,Kerr,TX,Rural Texas,322,8964000,27838.509316770185,351,12240000,34871.794871794875,-29,-3276000
2022,county,48491,Williamson,53033,King,WA,Seattle,762,79889000,104841.20734908136,280,21746000,77664.28571428571,482,58143000
2022,county,48453,Travis,53033,King,WA,Seattle,1128,186204000,165074.46808510637,774,74209000,95877.26098191214,354,111995000
2022,county,48209,Hays,53033,King,WA,Seattle,114,13077000,114710.52631578948,40,2045000,51125.0,74,11032000
2022,county,48029,Bexar,53033,King,WA,Seattle,443,26062000,58830.699774266366,335,19881000,59346.26865671642,108,6181000
2022,county,48491,Williamson,36047,Kings,NY,New York,142,6118000,43084.50704225352,33,2101000,63666.666666666664,109,4017000
2022,county,48453,Travis,36047,Kings,NY,New York,541,57149000,105635.8595194085,393,37541000,95524.17302798982,148,19608000
2022,county,48029,Bexar,36047,Kings,NY,New York,163,8724000,53521.47239263804,98,4320000,44081.63265306123,65,4404000
2022,county,48453,Travis,53035,Kitsap,WA,Rural Washington,46,5544000,120521.73913043478,74,3646000,49270.27027027027,-28,1898000
2022,county,48029,Bexar,53035,Kitsap,WA,Rural Washington,142,6164000,43408.45070422535,83,3194000,38481.927710843374,59,2970000
2022,county,48029,Bexar,48273,Kleberg,TX,Rural Texas,105,2634000,25085.714285714286,61,1925000,31557.377049180326,44,709000
2022,county,48453,Travis,47093,Knox,TN,Knoxville,47,3313000,70489.36170212766,61,3294000,54000.0,-14,19000
2022,county,48029,Bexar,47093,Knox,TN,Knoxville,51,1953000,38294.117647058825,55,1554000,28254.545454545456,-4,399000
2022,county,48029,Bexar,48283,La Salle,TX,Rural Texas,46,1039000,22586.956521739132,57,1391000,24403.508771929824,-11,-352000
2022,county,48453,Travis,22055,Lafayette Parish,LA,Rural Louisiana,105,4550000,43333.333333333336,39,2144000,54974.35897435898,66,2406000
2022,county,48029,Bexar,22055,Lafayette Parish,LA,Rural Louisiana,57,863000,15140.350877192983,70,1544000,22057.14285714286,-13,-681000
2022,county,48453,Travis,17097,Lake,IL,Chicago,129,17307000,134162.7906976744,55,3531000,64200.0,74,13776000
2022,county,48029,Bexar,17097,Lake,IL,Chicago,104,6467000,62182.692307692305,88,1451000,16488.636363636364,16,5016000
2022,county,48029,Bexar,18089,Lake,IN,Rural Indiana,84,2674000,31833.333333333332,32,1196000,37375.0,52,1478000
2022,county,48029,Bexar,12069,Lake,FL,Orlando,36,1267000,35194.444444444445,67,2681000,40014.92537313433,-31,-1414000
2022,county,48491,Williamson,48281,Lampasas,TX,Rural Texas,107,3547000,33149.53271028037,323,19359000,59934.98452012384,-216,-15812000
2022,county,48453,Travis,48281,Lampasas,TX,Rural Texas,40,2110000,52750.0,114,7142000,62649.12280701754,-74,-5032000
2022,county,48453,Travis,41039,Lane,OR,Rural Oregon,47,3975000,84574.46808510639,60,5140000,85666.66666666667,-13,-1165000
2022,county,48029,Bexar,56021,Laramie,WY,Rural Wyoming,109,2716000,24917.43119266055,57,1563000,27421.052631578947,52,1153000
2022,county,48491,Williamson,08069,Larimer,CO,Rural Colorado,57,2626000,46070.17543859649,69,4179000,60565.217391304344,-12,-1553000
2022,county,48453,Travis,08069,Larimer,CO,Rural Colorado,89,4709000,52910.11235955056,194,12795000,65953.60824742269,-105,-8086000
2022,county,48029,Bexar,08069,Larimer,CO,Rural Colorado,76,3795000,49934.21052631579,95,4714000,49621.05263157895,-19,-919000
2022,county,48029,Bexar,20103,Leavenworth,KS,Kansas City,67,1944000,29014.925373134327,48,1437000,29937.5,19,507000
2022,county,48491,Williamson,48287,Lee,TX,Rural Texas,61,1891000,31000.0,64,3240000,50625.0,-3,-1349000
2022,county,48453,Travis,12071,Lee,FL,S.W. Florida,76,5712000,75157.8947368421,85,9892000,116376.4705882353,-9,-4180000
2022,county,48453,Travis,48287,Lee,TX,Rural Texas,63,1276000,20253.968253968254,183,5862000,32032.786885245903,-120,-4586000
2022,county,48029,Bexar,12071,Lee,FL,S.W. Florida,82,2466000,30073.170731707316,82,2512000,30634.146341463416,0,-46000
2022,county,48453,Travis,12073,Leon,FL,Rural Florida,55,2645000,48090.90909090909,32,2313000,72281.25,23,332000
2022,county,48029,Bexar,13179,Liberty,GA,Rural Georgia,86,1425000,16569.767441860466,71,1542000,21718.309859154928,15,-117000
2022,county,48029,Bexar,48297,Live Oak,TX,Rural Texas,74,2070000,27972.972972972973,50,1932000,38640.0,24,138000
2022,county,48491,Williamson,48299,Llano,TX,Rural Texas,86,3979000,46267.441860465115,114,12861000,112815.78947368421,-28,-8882000
2022,county,48453,Travis,48299,Llano,TX,Rural Texas,68,5186000,76264.70588235294,255,20935000,82098.03921568628,-187,-15749000
2022,county,48029,Bexar,48299,Llano,TX,Rural Texas,71,3230000,45492.957746478874,61,9639000,158016.39344262294,10,-6409000
2022,county,48491,Williamson,06037,Los Angeles,CA,Los Angeles,1012,57083000,56406.12648221344,226,13855000,61305.30973451328,786,43228000
2022,county,48453,Travis,06037,Los Angeles,CA,Los Angeles,2053,278105000,135462.73745737944,913,173006000,189491.7853231106,1140,105099000
2022,county,48209,Hays,06037,Los Angeles,CA,Los Angeles,291,18635000,64037.80068728522,41,1504000,36682.92682926829,250,17131000
2022,county,48029,Bexar,06037,Los Angeles,CA,Los Angeles,1611,63720000,39553.072625698325,525,23119000,44036.19047619047,1086,40601000
2022,county,48453,Travis,51107,Loudoun,VA,Rural Virginia,94,6730000,71595.74468085106,58,4596000,79241.37931034483,36,2134000
2022,county,48029,Bexar,51107,Loudoun,VA,Rural Virginia,109,6592000,60477.064220183485,96,4418000,46020.833333333336,13,2174000
2022,county,48491,Williamson,48303,Lubbock,TX,Rural Texas,175,6835000,39057.142857142855,166,6573000,39596.385542168675,9,262000
2022,county,48453,Travis,48303,Lubbock,TX,Rural Texas,260,10544000,40553.846153846156,169,8154000,48248.52071005917,91,2390000
2022,county,48209,Hays,48303,Lubbock,TX,Rural Texas,55,2107000,38309.09090909091,41,1374000,33512.19512195122,14,733000
2022,county,48029,Bexar,48303,Lubbock,TX,Rural Texas,396,11899000,30047.9797979798,283,10702000,37816.25441696113,113,1197000
2022,county,48453,Travis,26099,Macomb,MI,Rural Michigan,98,5158000,52632.65306122449,41,1296000,31609.756097560974,57,3862000
2022,county,48453,Travis,01089,Madison,AL,Huntsville,36,1745000,48472.22222222222,35,1812000,51771.42857142857,1,-67000
2022,county,48029,Bexar,01089,Madison,AL,Huntsville,52,2221000,42711.53846153846,137,5146000,37562.04379562044,-85,-2925000
2022,county,48453,Travis,12081,Manatee,FL,Rural Florida,49,6824000,139265.306122449,50,3564000,71280.0,-1,3260000
2022,county,48029,Bexar,12081,Manatee,FL,Rural Florida,52,1706000,32807.692307692305,45,2424000,53866.666666666664,7,-718000
2022,county,48491,Williamson,04013,Maricopa,AZ,Phoenix,539,30163000,55961.03896103896,280,17772000,63471.42857142857,259,12391000
2022,county,48453,Travis,04013,Maricopa,AZ,Phoenix,900,86954000,96615.55555555556,544,49961000,91840.07352941176,356,36993000
2022,county,48209,Hays,04013,Maricopa,AZ,Phoenix,151,14779000,97874.17218543046,68,2702000,39735.294117647056,83,12077000
2022,county,48091,Comal,04013,Maricopa,AZ,Phoenix,138,7682000,55666.666666666664,52,3019000,58057.692307692305,86,4663000
2022,county,48029,Bexar,04013,Maricopa,AZ,Phoenix,1085,37078000,34173.27188940092,599,25701000,42906.51085141903,486,11377000
2022,county,48453,Travis,06041,Marin,CA,Bay Area,102,24391000,239127.45098039217,37,7240000,195675.67567567568,65,17151000
2022,county,48453,Travis,18097,Marion,IN,Indianapolis,118,8912000,75525.42372881356,87,4014000,46137.93103448276,31,4898000
2022,county,48453,Travis,41047,Marion,OR,Rural Oregon,28,879000,31392.85714285714,34,1594000,46882.35294117647,-6,-715000
2022,county,48029,Bexar,18097,Marion,IN,Indianapolis,167,3806000,22790.419161676647,92,3502000,38065.217391304344,75,304000
2022,county,48453,Travis,48323,Maverick,TX,Rural Texas,45,1100000,24444.444444444445,41,1086000,26487.80487804878,4,14000
2022,county,48029,Bexar,48323,Maverick,TX,Rural Texas,571,10945000,19168.12609457093,353,5181000,14677.053824362607,218,5764000
2022,county,48491,Williamson,48309,McLennan,TX,Rural Texas,305,11797000,38678.688524590165,340,13062000,38417.64705882353,-35,-1265000
2022,county,48453,Travis,48309,McLennan,TX,Rural Texas,302,11794000,39052.98013245033,329,21215000,64483.28267477204,-27,-9421000
2022,county,48209,Hays,48309,McLennan,TX,Rural Texas,52,1133000,21788.46153846154,87,3167000,36402.29885057471,-35,-2034000
2022,county,48091,Comal,48309,McLennan,TX,Rural Texas,39,1468000,37641.02564102564,40,1579000,39475.0,-1,-111000
2022,county,48029,Bexar,48309,McLennan,TX,Rural Texas,217,6277000,28926.26728110599,232,7800000,33620.68965517241,-15,-1523000
2022,county,48491,Williamson,37119,Mecklenburg,NC,Charlotte,99,7745000,78232.32323232324,81,4539000,56037.03703703704,18,3206000
2022,county,48453,Travis,37119,Mecklenburg,NC,Charlotte,172,16243000,94436.04651162791,228,20419000,89557.01754385965,-56,-4176000
2022,county,48029,Bexar,37119,Mecklenburg,NC,Charlotte,109,4414000,40495.4128440367,129,7708000,59751.93798449612,-20,-3294000
2022,county,48091,Comal,48325,Medina,TX,Rural Texas,51,2471000,48450.98039215686,49,2055000,41938.77551020408,2,416000
2022,county,48029,Bexar,48325,Medina,TX,Rural Texas,1311,33099000,25247.139588100687,2181,65040000,29821.18294360385,-870,-31941000
2022,county,48491,Williamson,12086,Miami-Dade,FL,Miami,196,7141000,36433.67346938775,62,4582000,73903.2258064516,134,2559000
2022,county,48453,Travis,12086,Miami-Dade,FL,Miami,390,29470000,75564.10256410256,339,55447000,163560.47197640117,51,-25977000
2022,county,48029,Bexar,12086,Miami-Dade,FL,Miami,394,17071000,43327.41116751269,169,6885000,40739.6449704142,225,10186000
2022,county,48453,Travis,25017,Middlesex,MA,Boston,446,39795000,89226.45739910314,236,30231000,128097.45762711864,210,9564000
2022,county,48453,Travis,34023,Middlesex,NJ,New York,152,9931000,65335.52631578947,49,2767000,56469.38775510204,103,7164000
2022,county,48029,Bexar,25017,Middlesex,MA,Boston,121,7910000,65371.90082644628,142,5320000,37464.788732394365,-21,2590000
2022,county,48029,Bexar,34023,Middlesex,NJ,New York,61,2683000,43983.60655737705,44,1860000,42272.72727272727,17,823000
2022,county,48491,Williamson,48329,Midland,TX,Rural Texas,65,3080000,47384.61538461538,54,1738000,32185.185185185186,11,1342000
2022,county,48453,Travis,48329,Midland,TX,Rural Texas,161,20303000,126105.5900621118,118,5256000,44542.372881355936,43,15047000
2022,county,48209,Hays,48329,Midland,TX,Rural Texas,44,2621000,59568.181818181816,32,1359000,42468.75,12,1262000
2022,county,48091,Comal,48329,Midland,TX,Rural Texas,70,4085000,58357.142857142855,46,1675000,36413.04347826087,24,2410000
2022,county,48029,Bexar,48329,Midland,TX,Rural Texas,253,9073000,35861.660079051384,224,9789000,43700.892857142855,29,-716000
2022,county,48491,Williamson,48331,Milam,TX,Rural Texas,145,3628000,25020.689655172413,437,16273000,37237.986270022884,-292,-12645000
2022,county,48453,Travis,48331,Milam,TX,Rural Texas,47,922000,19617.021276595744,187,9500000,50802.13903743315,-140,-8578000
2022,county,48453,Travis,55079,Milwaukee,WI,Milwaukee,117,9601000,82059.82905982906,76,4958000,65236.84210526316,41,4643000
2022,county,48029,Bexar,55079,Milwaukee,WI,Milwaukee,145,4417000,30462.068965517243,102,2197000,21539.21568627451,43,2220000
2022,county,48029,Bexar,01097,Mobile,AL,Mobile,53,1506000,28415.094339622643,81,2449000,30234.567901234568,-28,-943000
2022,county,48453,Travis,34025,Monmouth,NJ,New York,67,5216000,77850.74626865672,25,2186000,87440.0,42,3030000
2022,county,48453,Travis,36055,Monroe,NY,Rochester,91,5335000,58626.37362637363,75,3940000,52533.333333333336,16,1395000
2022,county,48029,Bexar,36055,Monroe,NY,Rochester,39,1285000,32948.717948717946,53,1995000,37641.50943396227,-14,-710000
2022,county,48453,Travis,06053,Monterey,CA,Rural California,64,5871000,91734.375,31,1429000,46096.77419354839,33,4442000
2022,county,48029,Bexar,06053,Monterey,CA,Rural California,227,6416000,28264.31718061674,72,2157000,29958.333333333332,155,4259000
2022,county,48491,Williamson,48339,Montgomery,TX,Houston,311,18373000,59077.17041800643,517,24724000,47822.0502901354,-206,-6351000
2022,county,48453,Travis,48339,Montgomery,TX,Houston,588,45371000,77161.56462585034,722,45707000,63306.09418282549,-134,-336000
2022,county,48453,Travis,24031,Montgomery,MD,D.C.,206,26086000,126631.06796116506,149,10510000,70536.91275167785,57,15576000
2022,county,48453,Travis,42091,Montgomery,PA,Philadelphia,89,8364000,93977.52808988764,54,4425000,81944.44444444444,35,3939000
2022,county,48453,Travis,39113,Montgomery,OH,Rural Ohio,34,2219000,65264.705882352944,35,943000,26942.85714285714,-1,1276000
2022,county,48209,Hays,48339,Montgomery,TX,Houston,197,8915000,45253.807106598986,129,5739000,44488.37209302326,68,3176000
2022,county,48091,Comal,48339,Montgomery,TX,Houston,142,9970000,70211.26760563381,125,5639000,45112.0,17,4331000
2022,county,48029,Bexar,48339,Montgomery,TX,Houston,358,17150000,47905.0279329609,605,29594000,48915.70247933884,-247,-12444000
2022,county,48029,Bexar,47125,Montgomery,TN,Rural Tennessee,239,5608000,23464.435146443513,152,3869000,25453.947368421053,87,1739000
2022,county,48029,Bexar,24031,Montgomery,MD,D.C.,146,12788000,87589.04109589041,176,8451000,48017.045454545456,-30,4337000
2022,county,48029,Bexar,39113,Montgomery,OH,Rural Ohio,141,4626000,32808.51063829787,97,2913000,30030.927835051545,44,1713000
2022,county,48029,Bexar,01101,Montgomery,AL,Montgomery,99,2831000,28595.959595959597,106,4492000,42377.35849056604,-7,-1661000
2022,county,48491,Williamson,41051,Multnomah,OR,Portland,54,4133000,76537.03703703704,51,2742000,53764.705882352944,3,1391000
2022,county,48453,Travis,41051,Multnomah,OR,Portland,239,20002000,83690.37656903766,271,21665000,79944.64944649447,-32,-1663000
2022,county,48029,Bexar,41051,Multnomah,OR,Portland,121,5255000,43429.7520661157,40,1638000,40950.0,81,3617000
2022,county,48029,Bexar,13215,Muscogee,GA,Columbus,137,3314000,24189.781021897812,47,1337000,28446.808510638297,90,1977000
2022,county,48453,Travis,48347,Nacogdoches,TX,Rural Texas,48,1774000,36958.333333333336,29,1519000,52379.31034482759,19,255000
2022,county,48453,Travis,36059,Nassau,NY,New York,161,13466000,83639.75155279503,39,4889000,125358.97435897436,122,8577000
2022,county,48453,Travis,10003,New Castle,DE,Rural Delaware,72,4115000,57152.77777777778,38,2438000,64157.89473684211,34,1677000
2022,county,48491,Williamson,36061,New York,NY,New York,92,7966000,86586.95652173914,55,6333000,115145.45454545454,37,1633000
2022,county,48453,Travis,36061,New York,NY,New York,645,163080000,252837.2093023256,546,71894000,131673.99267399267,99,91186000
2022,county,48029,Bexar,36061,New York,NY,New York,135,13519000,100140.74074074074,129,9692000,75131.78294573643,6,3827000
2022,county,48029,Bexar,51700,Newport News city,VA,Hampton Roads,107,2921000,27299.065420560746,101,2511000,24861.38613861386,6,410000
2022,county,48453,Travis,25021,Norfolk,MA,Boston,123,8690000,70650.40650406505,58,5347000,92189.6551724138,65,3343000
2022,county,48029,Bexar,51710,Norfolk city,VA,Hampton Roads,112,3033000,27080.35714285714,79,1986000,25139.240506329115,33,1047000
2022,county,48491,Williamson,48355,Nueces,TX,Rural Texas,224,8564000,38232.142857142855,205,13642000,66546.34146341463,19,-5078000
2022,county,48453,Travis,48355,Nueces,TX,Rural Texas,367,23418000,63809.26430517711,364,16098000,44225.27472527473,3,7320000
2022,county,48209,Hays,48355,Nueces,TX,Rural Texas,111,5264000,47423.423423423425,94,3273000,34819.14893617021,17,1991000
2022,county,48091,Comal,48355,Nueces,TX,Rural Texas,141,11405000,80886.52482269504,99,4380000,44242.42424242424,42,7025000
2022,county,48029,Bexar,48355,Nueces,TX,Rural Texas,1474,54450000,36940.298507462685,957,34553000,36105.5381400209,517,19897000
2022,county,48453,Travis,26125,Oakland,MI,Detroit,269,20068000,74602.23048327137,99,8807000,88959.59595959596,170,11261000
2022,county,48029,Bexar,26125,Oakland,MI,Detroit,123,5380000,43739.83739837398,83,2161000,26036.14457831325,40,3219000
2022,county,48453,Travis,12091,Okaloosa,FL,FL Panhandle,40,1053000,26325.0,38,1386000,36473.68421052631,2,-333000
2022,county,48029,Bexar,12091,Okaloosa,FL,FL Panhandle,283,9125000,32243.81625441696,286,9677000,33835.66433566433,-3,-552000
2022,county,48491,Williamson,40109,Oklahoma,OK,Oklahoma City,68,2701000,39720.58823529412,76,2646000,34815.78947368421,-8,55000
2022,county,48453,Travis,40109,Oklahoma,OK,Oklahoma City,156,12723000,81557.69230769231,154,6110000,39675.32467532468,2,6613000
2022,county,48029,Bexar,40109,Oklahoma,OK,Oklahoma City,203,9029000,44477.83251231527,243,9781000,40251.02880658436,-40,-752000
2022,county,48029,Bexar,37133,Onslow,NC,Rural North Carolina,200,5031000,25155.0,120,2563000,21358.333333333332,80,2468000
2022,county,48491,Williamson,06059,Orange,CA,Los Angeles,643,36222000,56332.81493001555,155,11851000,76458.06451612903,488,24371000
2022,county,48491,Williamson,12095,Orange,FL,Orlando,100,3944000,39440.0,127,7060000,55590.55118110236,-27,-3116000
2022,county,48453,Travis,06059,Orange,CA,Los Angeles,827,92930000,112370.01209189843,290,22641000,78072.41379310345,537,70289000
2022,county,48453,Travis,12095,Orange,FL,Orlando,205,10106000,49297.560975609755,209,13511000,64645.933014354065,-4,-3405000
2022,county,48453,Travis,37135,Orange,NC,Raleigh,32,5104000,159500.0,38,2942000,77421.05263157895,-6,2162000
2022,county,48029,Bexar,06059,Orange,CA,Los Angeles,702,33086000,47131.05413105413,228,10013000,43916.666666666664,474,23073000
2022,county,48029,Bexar,12095,Orange,FL,Orlando,194,5941000,30623.711340206184,211,11054000,52388.62559241706,-17,-5113000
2022,county,48029,Bexar,36071,Orange,NY,Rural New York,68,1851000,27220.58823529412,49,1547000,31571.428571428572,19,304000
2022,county,48453,Travis,22071,Orleans Parish,LA,New Orleans,162,9152000,56493.82716049383,105,8516000,81104.76190476191,57,636000
2022,county,48029,Bexar,22071,Orleans Parish,LA,New Orleans,103,4016000,38990.29126213592,72,2207000,30652.777777777777,31,1809000
2022,county,48453,Travis,12097,Osceola,FL,Orlando,37,1771000,47864.86486486487,31,1383000,44612.903225806454,6,388000
2022,county,48029,Bexar,12097,Osceola,FL,Orlando,53,1655000,31226.415094339623,79,2019000,25556.962025316454,-26,-364000
2022,county,48029,Bexar,35035,Otero,NM,Rural New Mexico,66,2271000,34409.09090909091,61,1005000,16475.409836065573,5,1266000
2022,county,48491,Williamson,12099,Palm Beach,FL,Miami,87,3911000,44954.02298850575,70,3192000,45600.0,17,719000
2022,county,48453,Travis,12099,Palm Beach,FL,Miami,184,14104000,76652.17391304347,144,21539000,149576.38888888888,40,-7435000
2022,county,48029,Bexar,12099,Palm Beach,FL,Miami,110,3579000,32536.363636363636,92,4411000,47945.65217391304,18,-832000
2022,county,48453,Travis,48367,Parker,TX,Dallas-Fort Worth,58,2726000,47000.0,119,8192000,68840.33613445378,-61,-5466000
2022,county,48029,Bexar,48367,Parker,TX,Dallas-Fort Worth,52,2051000,39442.307692307695,93,4720000,50752.68817204301,-41,-2669000
2022,county,48029,Bexar,12101,Pasco,FL,Tampa,94,3404000,36212.765957446805,115,3926000,34139.13043478261,-21,-522000
2022,county,48453,Travis,42101,Philadelphia,PA,Philadelphia,176,16000000,90909.09090909091,159,9911000,62333.333333333336,17,6089000
2022,county,48029,Bexar,42101,Philadelphia,PA,Philadelphia,75,2593000,34573.333333333336,66,2589000,39227.27272727273,9,4000
2022,county,48491,Williamson,53053,Pierce,WA,Seattle,156,4632000,29692.30769230769,65,3415000,52538.46153846154,91,1217000
2022,county,48453,Travis,53053,Pierce,WA,Seattle,108,8668000,80259.25925925926,122,7425000,60860.65573770492,-14,1243000
2022,county,48029,Bexar,53053,Pierce,WA,Seattle,566,17882000,31593.63957597173,324,10077000,31101.85185185185,242,7805000
2022,county,48491,Williamson,04019,Pima,AZ,Tucson,94,3844000,40893.617021276594,63,2710000,43015.87301587302,31,1134000
2022,county,48453,Travis,04019,Pima,AZ,Tucson,160,12361000,77256.25,152,7645000,50296.05263157895,8,4716000
2022,county,48029,Bexar,04019,Pima,AZ,Tucson,337,11197000,33225.51928783383,256,7698000,30070.3125,81,3499000
2022,county,48029,Bexar,04021,Pinal,AZ,Phoenix,117,2850000,24358.97435897436,65,1639000,25215.384615384617,52,1211000
2022,county,48491,Williamson,12103,Pinellas,FL,Tampa,55,3259000,59254.545454545456,59,2848000,48271.186440677964,-4,411000
2022,county,48453,Travis,12103,Pinellas,FL,Tampa,114,7308000,64105.26315789474,142,17341000,122119.71830985915,-28,-10033000
2022,county,48029,Bexar,12103,Pinellas,FL,Tampa,112,3873000,34580.357142857145,80,4583000,57287.5,32,-710000
2022,county,48453,Travis,06061,Placer,CA,Sacramento,69,7448000,107942.02898550725,42,2974000,70809.52380952382,27,4474000
2022,county,48491,Williamson,12105,Polk,FL,Orlando,40,1555000,38875.0,53,2033000,38358.49056603773,-13,-478000
2022,county,48491,Williamson,48373,Polk,TX,Rural Texas,39,1600000,41025.64102564102,73,3351000,45904.109589041094,-34,-1751000
2022,county,48453,Travis,19153,Polk,IA,Rural Iowa,75,4613000,61506.666666666664,37,2129000,57540.54054054054,38,2484000
2022,county,48453,Travis,12105,Polk,FL,Orlando,44,1902000,43227.27272727273,59,3206000,54338.983050847455,-15,-1304000
2022,county,48029,Bexar,19153,Polk,IA,Rural Iowa,57,1392000,24421.052631578947,57,2048000,35929.82456140351,0,-656000
2022,county,48029,Bexar,12105,Polk,FL,Orlando,67,1391000,20761.194029850747,100,2526000,25260.0,-33,-1135000
2022,county,48029,Bexar,48373,Polk,TX,Rural Texas,38,1435000,37763.15789473684,60,2723000,45383.333333333336,-22,-1288000
2022,county,48453,Travis,48375,Potter,TX,Rural Texas,41,1796000,43804.87804878049,44,1742000,39590.90909090909,-3,54000
2022,county,48029,Bexar,48375,Potter,TX,Rural Texas,75,2316000,30880.0,46,1068000,23217.391304347828,29,1248000
2022,county,48453,Travis,24033,Prince George,MD,Rural Maryland,64,3496000,54625.0,28,1402000,50071.42857142857,36,2094000
2022,county,48029,Bexar,24033,Prince George,MD,Rural Maryland,150,7519000,50126.666666666664,105,4960000,47238.09523809524,45,2559000
2022,county,48029,Bexar,51153,Prince William,VA,Rural Virginia,174,6638000,38149.425287356324,130,4410000,33923.07692307692,44,2228000
2022,county,48453,Travis,44007,Providence,RI,Providence,51,2896000,56784.313725490196,63,3407000,54079.36507936508,-12,-511000
2022,county,48029,Bexar,44007,Providence,RI,Providence,52,2253000,43326.92307692308,30,847000,28233.333333333332,22,1406000
2022,county,48453,Travis,05119,Pulaski,AR,Little Rock,62,3405000,54919.354838709674,74,4947000,66851.35135135135,-12,-1542000
2022,county,48029,Bexar,05119,Pulaski,AR,Little Rock,103,3899000,37854.36893203884,86,3429000,39872.09302325582,17,470000
2022,county,48029,Bexar,29169,Pulaski,MO,Rural Missouri,69,1735000,25144.927536231884,54,1350000,25000.0,15,385000
2022,county,48453,Travis,36081,Queens,NY,New York,245,21920000,89469.38775510204,104,6602000,63480.769230769234,141,15318000
2022,county,48029,Bexar,36081,Queens,NY,New York,173,6357000,36745.66473988439,64,2813000,43953.125,109,3544000
2022,county,48453,Travis,27123,Ramsey,MN,Minneapolis,68,4415000,64926.470588235294,58,3502000,60379.31034482759,10,913000
2022,county,48029,Bexar,27123,Ramsey,MN,Minneapolis,43,2073000,48209.3023255814,50,1324000,26480.0,-7,749000
2022,county,48453,Travis,48381,Randall,TX,Rural Texas,88,2505000,28465.909090909092,42,1551000,36928.57142857143,46,954000
2022,county,48029,Bexar,48381,Randall,TX,Rural Texas,121,3501000,28933.88429752066,86,3115000,36220.93023255814,35,386000
2022,county,48029,Bexar,45079,Richland,SC,Columbia,132,3346000,25348.484848484848,99,3084000,31151.515151515152,33,262000
2022,county,48029,Bexar,13245,Richmond,GA,Rural Georgia,114,3755000,32938.59649122807,36,1186000,32944.444444444445,78,2569000
2022,county,48453,Travis,51760,Richmond city,VA,Richmond,56,4574000,81678.57142857143,72,4426000,61472.22222222222,-16,148000
2022,county,48029,Bexar,20161,Riley,KS,Rural Kansas,56,1532000,27357.14285714286,35,1260000,36000.0,21,272000
2022,county,48491,Williamson,06065,Riverside,CA,San Bernardino-Riverside,317,13084000,41274.44794952682,122,5638000,46213.11475409836,195,7446000
2022,county,48453,Travis,06065,Riverside,CA,San Bernardino-Riverside,298,16586000,55657.718120805366,119,6893000,57924.36974789916,179,9693000
2022,county,48029,Bexar,06065,Riverside,CA,San Bernardino-Riverside,758,21016000,27725.593667546174,194,7242000,37329.8969072165,564,13774000
2022,county,48453,Travis,48397,Rockwall,TX,Dallas-Fort Worth,59,4084000,69220.33898305085,65,3531000,54323.07692307692,-6,553000
2022,county,48029,Bexar,48397,Rockwall,TX,Dallas-Fort Worth,45,2211000,49133.333333333336,69,3295000,47753.6231884058,-24,-1084000
2022,county,48491,Williamson,06067,Sacramento,CA,Sacramento,163,10697000,65625.76687116564,55,3222000,58581.818181818184,108,7475000
2022,county,48453,Travis,06067,Sacramento,CA,Sacramento,220,14215000,64613.63636363636,117,9556000,81675.21367521367,103,4659000
2022,county,48029,Bexar,06067,Sacramento,CA,Sacramento,392,11670000,29770.408163265307,102,4466000,43784.313725490196,290,7204000
2022,county,48491,Williamson,49035,Salt Lake,UT,Salt Lake,148,8926000,60310.81081081081,68,3486000,51264.705882352944,80,5440000
2022,county,48453,Travis,49035,Salt Lake,UT,Salt Lake,216,20986000,97157.4074074074,180,12462000,69233.33333333333,36,8524000
2022,county,48029,Bexar,49035,Salt Lake,UT,Salt Lake,240,6778000,28241.666666666668,135,5342000,39570.37037037037,105,1436000
2022,county,48491,Williamson,06071,San Bernardino,CA,San Bernardino-Riverside,224,8478000,37848.21428571428,73,1776000,24328.76712328767,151,6702000
2022,county,48453,Travis,06071,San Bernardino,CA,San Bernardino-Riverside,170,6228000,36635.294117647056,64,2851000,44546.875,106,3377000
2022,county,48029,Bexar,06071,San Bernardino,CA,San Bernardino-Riverside,679,21918000,32279.823269513992,216,6424000,29740.74074074074,463,15494000
2022,county,48491,Williamson,06073,San Diego,CA,San Diego,541,32020000,59186.69131238447,220,10710000,48681.818181818184,321,21310000
2022,county,48453,Travis,06073,San Diego,CA,San Diego,905,79306000,87630.93922651933,534,59461000,111350.1872659176,371,19845000
2022,county,48209,Hays,06073,San Diego,CA,San Diego,146,8161000,55897.260273972606,63,2340000,37142.857142857145,83,5821000
2022,county,48091,Comal,06073,San Diego,CA,San Diego,243,13533000,55691.358024691355,40,1513000,37825.0,203,12020000
2022,county,48029,Bexar,06073,San Diego,CA,San Diego,1336,47358000,35447.60479041916,601,17861000,29718.801996672213,735,29497000
2022,county,48491,Williamson,06075,San Francisco,CA,Bay Area,114,16989000,149026.31578947368,48,6749000,140604.16666666666,66,10240000
2022,county,48453,Travis,06075,San Francisco,CA,Bay Area,582,158702000,272683.84879725083,233,35597000,152776.82403433477,349,123105000
2022,county,48029,Bexar,06075,San Francisco,CA,Bay Area,55,6176000,112290.90909090909,44,3272000,74363.63636363637,11,2904000
2022,county,48453,Travis,06077,San Joaquin,CA,Bay Area,121,10343000,85479.33884297521,40,2877000,71925.0,81,7466000
2022,county,48491,Williamson,06081,San Mateo,CA,Bay Area,216,25268000,116981.48148148147,32,3380000,105625.0,184,21888000
2022,county,48453,Travis,06081,San Mateo,CA,Bay Area,317,64752000,204264.98422712935,137,27636000,201722.62773722628,180,37116000
2022,county,48029,Bexar,06081,San Mateo,CA,Bay Area,77,5880000,76363.63636363637,34,3278000,96411.76470588235,43,2602000
2022,county,48453,Travis,48409,San Patricio,TX,Rural Texas,51,1870000,36666.666666666664,69,2833000,41057.97101449275,-18,-963000
2022,county,48029,Bexar,48409,San Patricio,TX,Rural Texas,187,4453000,23812.83422459893,221,5950000,26923.076923076922,-34,-1497000
2022,county,48029,Bexar,35043,Sandoval,NM,Albuquerque,57,1879000,32964.912280701756,52,1700000,32692.30769230769,5,179000
2022,county,48453,Travis,06083,Santa Barbara,CA,Rural California,95,17132000,180336.84210526315,34,2242000,65941.17647058824,61,14890000
2022,county,48029,Bexar,06083,Santa Barbara,CA,Rural California,121,3044000,25157.02479338843,46,1095000,23804.347826086956,75,1949000
2022,county,48491,Williamson,06085,Santa Clara,CA,Bay Area,1485,177150000,119292.92929292929,162,16408000,101283.95061728395,1323,160742000
2022,county,48453,Travis,06085,Santa Clara,CA,Bay Area,1414,269645000,190696.6053748232,492,65164000,132447.15447154472,922,204481000
2022,county,48029,Bexar,06085,Santa Clara,CA,Bay Area,257,17964000,69898.8326848249,108,6836000,63296.2962962963,149,11128000
2022,county,48453,Travis,06087,Santa Cruz,CA,Bay Area,47,6730000,143191.48936170212,36,2490000,69166.66666666667,11,4240000
2022,county,48453,Travis,35049,Santa Fe,NM,Rural New Mexico,70,3946000,56371.42857142857,141,21225000,150531.914893617,-71,-17279000
2022,county,48029,Bexar,35049,Santa Fe,NM,Rural New Mexico,29,1401000,48310.34482758621,40,2209000,55225.0,-11,-808000
2022,county,48029,Bexar,12113,Santa Rosa,FL,FL Panhandle,113,3813000,33743.36283185841,145,4051000,27937.931034482757,-32,-238000
2022,county,48453,Travis,12115,Sarasota,FL,S.W. Florida,50,4340000,86800.0,58,7674000,132310.3448275862,-8,-3334000
2022,county,48029,Bexar,12115,Sarasota,FL,S.W. Florida,44,1847000,41977.27272727273,51,8768000,171921.568627451,-7,-6921000
2022,county,48029,Bexar,31153,Sarpy,NE,Omaha,117,3459000,29564.102564102563,97,2570000,26494.845360824744,20,889000
2022,county,48491,Williamson,20173,Sedgwick,KS,Rural Kansas,48,962000,20041.666666666668,42,2148000,51142.857142857145,6,-1186000
2022,county,48453,Travis,20173,Sedgwick,KS,Rural Kansas,69,2910000,42173.913043478264,58,2676000,46137.93103448276,11,234000
2022,county,48029,Bexar,20173,Sedgwick,KS,Rural Kansas,122,3488000,28590.16393442623,96,3135000,32656.25,26,353000
2022,county,48453,Travis,12117,Seminole,FL,Orlando,61,3516000,57639.34426229508,42,2410000,57380.95238095238,19,1106000
2022,county,48029,Bexar,12117,Seminole,FL,Orlando,53,2396000,45207.54716981132,58,1993000,34362.06896551724,-5,403000
2022,county,48453,Travis,47157,Shelby,TN,Memphis,135,7659000,56733.333333333336,96,1809000,18843.75,39,5850000
2022,county,48029,Bexar,47157,Shelby,TN,Memphis,128,4535000,35429.6875,99,2705000,27323.23232323232,29,1830000
2022,county,48491,Williamson,48423,Smith,TX,Rural Texas,111,6843000,61648.64864864865,155,7307000,47141.93548387097,-44,-464000
2022,county,48453,Travis,48423,Smith,TX,Rural Texas,157,9217000,58707.00636942675,192,12426000,64718.75,-35,-3209000
2022,county,48209,Hays,48423,Smith,TX,Rural Texas,35,1372000,39200.0,39,1857000,47615.38461538462,-4,-485000
2022,county,48029,Bexar,48423,Smith,TX,Rural Texas,121,4029000,33297.520661157025,116,4417000,38077.58620689655,5,-388000
2022,county,48491,Williamson,53061,Snohomish,WA,Seattle,277,23880000,86209.38628158845,70,3874000,55342.857142857145,207,20006000
2022,county,48453,Travis,53061,Snohomish,WA,Seattle,180,12555000,69750.0,97,6676000,68824.74226804124,83,5879000
2022,county,48029,Bexar,53061,Snohomish,WA,Seattle,299,12369000,41367.89297658863,127,6668000,52503.93700787402,172,5701000
2022,county,48453,Travis,06095,Solano,CA,Bay Area,37,2357000,63702.7027027027,47,2005000,42659.574468085106,-10,352000
2022,county,48029,Bexar,06095,Solano,CA,Bay Area,279,10367000,37157.70609318996,148,5529000,37358.10810810811,131,4838000
2022,county,48453,Travis,34035,Somerset,NJ,New York,65,7056000,108553.84615384616,35,2414000,68971.42857142857,30,4642000
2022,county,48453,Travis,06097,Sonoma,CA,Bay Area,77,5710000,74155.84415584416,39,2768000,70974.35897435897,38,2942000
2022,county,48453,Travis,09170,South Central CT Planning Region,CT,New Haven,75,5101000,68013.33333333333,66,2947000,44651.51515151515,9,2154000
2022,county,48453,Travis,53063,Spokane,WA,Spokane,77,4759000,61805.194805194806,55,3062000,55672.72727272727,22,1697000
2022,county,48029,Bexar,53063,Spokane,WA,Spokane,120,5365000,44708.333333333336,86,3631000,42220.93023255814,34,1734000
2022,county,48029,Bexar,29183,St. Charles,MO,St. Louis,41,2243000,54707.31707317073,49,1719000,35081.63265306123,-8,524000
2022,county,48029,Bexar,17163,St. Clair,IL,St. Louis,222,6748000,30396.396396396398,147,4471000,30414.965986394556,75,2277000
2022,county,48453,Travis,12109,St. Johns,FL,Jacksonville,39,2481000,63615.38461538462,48,4834000,100708.33333333333,-9,-2353000
2022,county,48029,Bexar,12109,St. Johns,FL,Jacksonville,37,1934000,52270.27027027027,37,1884000,50918.91891891892,0,50000
2022,county,48491,Williamson,29189,St. Louis,MO,St. Louis,76,3823000,50302.63157894737,192,11778000,61343.75,-116,-7955000
2022,county,48453,Travis,29189,St. Louis,MO,St. Louis,159,23161000,145666.66666666666,88,6245000,70965.90909090909,71,16916000
2022,county,48029,Bexar,29189,St. Louis,MO,St. Louis,122,4516000,37016.39344262295,99,5896000,59555.555555555555,23,-1380000
2022,county,48453,Travis,29510,St. Louis city,MO,Rural Missouri,86,6855000,79709.30232558139,42,3345000,79642.85714285714,44,3510000
2022,county,48029,Bexar,29510,St. Louis city,MO,Rural Missouri,60,2467000,41116.666666666664,49,1936000,39510.204081632655,11,531000
2022,county,48453,Travis,22103,St. Tammany Parish,LA,New Orleans,54,3952000,73185.18518518518,41,2096000,51121.95121951219,13,1856000
2022,county,48029,Bexar,22103,St. Tammany Parish,LA,New Orleans,70,3685000,52642.857142857145,55,2435000,44272.72727272727,15,1250000
2022,county,48029,Bexar,48427,Starr,TX,Rural Texas,61,1655000,27131.147540983606,46,948000,20608.695652173912,15,707000
2022,county,48453,Travis,25025,Suffolk,MA,Boston,320,32430000,101343.75,127,9607000,75645.66929133858,193,22823000
2022,county,48453,Travis,36103,Suffolk,NY,New York,155,19954000,128735.48387096774,38,3025000,79605.26315789473,117,16929000
2022,county,48029,Bexar,25025,Suffolk,MA,Boston,60,3507000,58450.0,71,4740000,66760.56338028169,-11,-1233000
2022,county,48029,Bexar,45085,Sumter,SC,Rural South Carolina,72,1702000,23638.88888888889,66,2312000,35030.30303030303,6,-610000
2022,county,48491,Williamson,48439,Tarrant,TX,Dallas-Fort Worth,582,29193000,50159.79381443299,619,29120000,47043.61873990307,-37,73000
2022,county,48453,Travis,48439,Tarrant,TX,Dallas-Fort Worth,1095,69457000,63431.0502283105,1300,73344000,56418.46153846154,-205,-3887000
2022,county,48209,Hays,48439,Tarrant,TX,Dallas-Fort Worth,223,10257000,45995.51569506727,205,8361000,40785.365853658535,18,1896000
2022,county,48091,Comal,48439,Tarrant,TX,Dallas-Fort Worth,150,9264000,61760.0,127,5832000,45921.259842519685,23,3432000
2022,county,48029,Bexar,48439,Tarrant,TX,Dallas-Fort Worth,1048,32131000,30659.351145038167,1322,46091000,34864.599092284414,-274,-13960000
2022,county,48491,Williamson,48441,Taylor,TX,Rural Texas,77,2734000,35506.493506493505,95,2608000,27452.63157894737,-18,126000
2022,county,48453,Travis,48441,Taylor,TX,Rural Texas,113,3273000,28964.601769911504,67,2384000,35582.08955223881,46,889000
2022,county,48029,Bexar,48441,Taylor,TX,Rural Texas,249,7012000,28160.642570281125,205,6257000,30521.951219512193,44,755000
2022,county,48029,Bexar,53067,Thurston,WA,Rural Washington,247,6566000,26582.995951417004,144,4120000,28611.11111111111,103,2446000
2022,county,48491,Williamson,48451,Tom Green,TX,Rural Texas,100,2824000,28240.0,108,4625000,42824.07407407407,-8,-1801000
2022,county,48453,Travis,48451,Tom Green,TX,Rural Texas,132,5696000,43151.51515151515,88,4223000,47988.63636363636,44,1473000
2022,county,48029,Bexar,48451,Tom Green,TX,Rural Texas,343,8520000,24839.650145772594,245,6307000,25742.85714285714,98,2213000
2022,county,48491,Williamson,48453,Travis,TX,Austin,21326,1142997000,53596.40814029823,12910,647687000,50169.40356312936,8416,495310000
2022,county,48209,Hays,48453,Travis,TX,Austin,9886,696238000,70426.66396924945,3587,178199000,49679.11904098132,6299,518039000
2022,county,48091,Comal,48453,Travis,TX,Austin,1112,73056000,65697.8417266187,352,17794000,50551.13636363636,760,55262000
2022,county,48029,Bexar,48453,Travis,TX,Austin,2980,150532000,50514.093959731545,2618,229376000,87614.97326203209,362,-78844000
2022,county,48491,Williamson,40143,Tulsa,OK,Tulsa,71,2300000,32394.3661971831,100,5438000,54380.0,-29,-3138000
2022,county,48453,Travis,40143,Tulsa,OK,Tulsa,120,5726000,47716.666666666664,144,8008000,55611.11111111111,-24,-2282000
2022,county,48029,Bexar,40143,Tulsa,OK,Tulsa,111,4766000,42936.93693693694,101,4002000,39623.762376237624,10,764000
2022,county,48491,Williamson,49049,Utah,UT,Rural Utah,89,3934000,44202.247191011236,65,2250000,34615.38461538462,24,1684000
2022,county,48453,Travis,49049,Utah,UT,Rural Utah,141,9520000,67517.7304964539,70,7112000,101600.0,71,2408000
2022,county,48029,Bexar,49049,Utah,UT,Rural Utah,178,4130000,23202.247191011236,109,3009000,27605.504587155963,69,1121000
2022,county,48029,Bexar,48463,Uvalde,TX,Rural Texas,202,7649000,37866.33663366337,161,4217000,26192.54658385093,41,3432000
2022,county,48029,Bexar,48465,Val Verde,TX,Rural Texas,348,9890000,28419.540229885057,277,7758000,28007.2202166065,71,2132000
2022,county,48453,Travis,06111,Ventura,CA,Los Angeles,164,15012000,91536.58536585367,57,5425000,95175.43859649122,107,9587000
2022,county,48029,Bexar,06111,Ventura,CA,Los Angeles,189,6196000,32783.06878306878,56,1462000,26107.14285714286,133,4734000
2022,county,48029,Bexar,22115,Vernon Parish,LA,Rural Louisiana,115,2710000,23565.217391304348,72,1580000,21944.444444444445,43,1130000
2022,county,48491,Williamson,48469,Victoria,TX,Rural Texas,78,2343000,30038.46153846154,62,2119000,34177.41935483871,16,224000
2022,county,48453,Travis,48469,Victoria,TX,Rural Texas,107,3605000,33691.588785046726,85,3023000,35564.705882352944,22,582000
2022,county,48209,Hays,48469,Victoria,TX,Rural Texas,43,1013000,23558.13953488372,56,2260000,40357.142857142855,-13,-1247000
2022,county,48029,Bexar,48469,Victoria,TX,Rural Texas,226,6195000,27411.504424778763,146,3907000,26760.27397260274,80,2288000
2022,county,48453,Travis,51810,Virginia Beach city,VA,Hampton Roads,51,3765000,73823.5294117647,30,1660000,55333.333333333336,21,2105000
2022,county,48029,Bexar,51810,Virginia Beach city,VA,Hampton Roads,198,5620000,28383.838383838385,117,3173000,27119.65811965812,81,2447000
2022,county,48453,Travis,12127,Volusia,FL,Atlantic Coast,41,1888000,46048.78048780488,34,2157000,63441.17647058824,7,-269000
2022,county,48029,Bexar,12127,Volusia,FL,Atlantic Coast,49,1438000,29346.938775510203,80,2591000,32387.5,-31,-1153000
2022,county,48491,Williamson,37183,Wake,NC,Raleigh,95,6542000,68863.15789473684,129,6391000,49542.635658914725,-34,151000
2022,county,48453,Travis,37183,Wake,NC,Raleigh,212,16036000,75641.50943396226,256,20530000,80195.3125,-44,-4494000
2022,county,48029,Bexar,37183,Wake,NC,Raleigh,108,4787000,44324.07407407407,134,5906000,44074.62686567164,-26,-1119000
2022,county,48491,Williamson,48471,Walker,TX,Rural Texas,27,756000,28000.0,38,1563000,41131.57894736842,-11,-807000
2022,county,48453,Travis,48471,Walker,TX,Rural Texas,60,2073000,34550.0,49,2101000,42877.551020408166,11,-28000
2022,county,48029,Bexar,48471,Walker,TX,Rural Texas,61,1629000,26704.918032786885,40,941000,23525.0,21,688000
2022,county,48491,Williamson,41067,Washington,OR,Portland,271,21725000,80166.0516605166,50,3116000,62320.0,221,18609000
2022,county,48453,Travis,41067,Washington,OR,Portland,277,23936000,86411.5523465704,149,7537000,50583.89261744967,128,16399000
2022,county,48453,Travis,05143,Washington,AR,Rural Arkansas,53,1945000,36698.11320754717,96,4796000,49958.333333333336,-43,-2851000
2022,county,48453,Travis,48477,Washington,TX,Rural Texas,35,2122000,60628.57142857143,67,4899000,73119.40298507463,-32,-2777000
2022,county,48029,Bexar,41067,Washington,OR,Portland,100,4783000,47830.0,73,8942000,122493.1506849315,27,-4159000
2022,county,48491,Williamson,32031,Washoe,NV,Rural Nevada,59,5442000,92237.28813559322,34,2879000,84676.4705882353,25,2563000
2022,county,48453,Travis,32031,Washoe,NV,Rural Nevada,182,30493000,167543.95604395604,65,8618000,132584.61538461538,117,21875000
2022,county,48029,Bexar,32031,Washoe,NV,Rural Nevada,65,2657000,40876.92307692308,50,2776000,55520.0,15,-119000
2022,county,48453,Travis,26161,Washtenaw,MI,Rural Michigan,105,13213000,125838.09523809524,89,6018000,67617.97752808989,16,7195000
2022,county,48453,Travis,26163,Wayne,MI,Detroit,158,8753000,55398.73417721519,79,3682000,46607.59493670886,79,5071000
2022,county,48029,Bexar,26163,Wayne,MI,Detroit,122,2865000,23483.60655737705,84,1901000,22630.95238095238,38,964000
2022,county,48491,Williamson,48479,Webb,TX,Rural Texas,94,3935000,41861.70212765958,51,861000,16882.352941176472,43,3074000
2022,county,48453,Travis,48479,Webb,TX,Rural Texas,200,5552000,27760.0,111,4643000,41828.82882882883,89,909000
2022,county,48209,Hays,48479,Webb,TX,Rural Texas,58,2247000,38741.379310344826,34,671000,19735.29411764706,24,1576000
2022,county,48029,Bexar,48479,Webb,TX,Rural Texas,1548,42963000,27753.875968992248,600,13775000,22958.333333333332,948,29188000
2022,county,48453,Travis,08123,Weld,CO,Rural Colorado,38,1439000,37868.42105263158,40,1944000,48600.0,-2,-505000
2022,county,48029,Bexar,08123,Weld,CO,Rural Colorado,86,2268000,26372.093023255813,56,1393000,24875.0,30,875000
2022,county,48453,Travis,36119,Westchester,NY,New York,142,17131000,120640.84507042254,47,6464000,137531.914893617,95,10667000
2022,county,48453,Travis,09190,Western Connecticut,CT,New York,147,24355000,165680.27210884355,89,10682000,120022.47191011236,58,13673000
2022,county,48453,Travis,53073,Whatcom,WA,Rural Washington,23,1476000,64173.913043478264,38,5043000,132710.52631578947,-15,-3567000
2022,county,48453,Travis,48485,Wichita,TX,Rural Texas,54,3495000,64722.22222222222,77,3991000,51831.168831168834,-23,-496000
2022,county,48029,Bexar,48485,Wichita,TX,Rural Texas,126,4153000,32960.31746031746,133,-111820000,-840751.8796992481,-7,115973000
2022,county,48453,Travis,17197,Will,IL,Chicago,65,3274000,50369.230769230766,37,2094000,56594.59459459459,28,1180000
2022,county,48029,Bexar,17197,Will,IL,Chicago,93,2841000,30548.387096774193,46,1322000,28739.130434782608,47,1519000
2022,county,48453,Travis,48491,Williamson,TX,Austin,12910,647687000,50169.40356312936,21326,1142997000,53596.40814029823,-8416,-495310000
2022,county,48453,Travis,47187,Williamson,TN,Nashville,67,4480000,66865.67164179105,89,8539000,95943.82022471911,-22,-4059000
2022,county,48209,Hays,48491,Williamson,TX,Austin,1119,48608000,43438.78462913315,783,34687000,44300.12771392082,336,13921000
2022,county,48091,Comal,48491,Williamson,TX,Austin,502,26415000,52619.521912350596,182,8133000,44686.81318681319,320,18282000
2022,county,48029,Bexar,48491,Williamson,TX,Austin,1196,46972000,39274.247491638795,1090,50687000,46501.83486238532,106,-3715000
2022,county,48091,Comal,48493,Wilson,TX,Rural Texas,112,4524000,40392.857142857145,136,6142000,45161.76470588235,-24,-1618000
2022,county,48029,Bexar,48493,Wilson,TX,Rural Texas,1002,28259000,28202.59481037924,1859,60780000,32694.997310381925,-857,-32521000
2022,county,48453,Travis,25027,Worcester,MA,Rural Massachusetts,100,7046000,70460.0,38,1926000,50684.21052631579,62,5120000
2022,county,48029,Bexar,25027,Worcester,MA,Rural Massachusetts,53,1553000,29301.88679245283,35,1283000,36657.142857142855,18,270000
2022,county,48453,Travis,04025,Yavapai,AZ,Rural Arizona,27,1171000,43370.37037037037,52,4089000,78634.61538461539,-25,-2918000
2022,county,48029,Bexar,51199,York,VA,Hampton Roads,81,2515000,31049.382716049382,71,2050000,28873.23943661972,10,465000
2022,county,48029,Bexar,48507,Zavala,TX,Rural Texas,48,1232000,25666.666666666668,40,1098000,27450.0,8,134000
2022,total,48491,Williamson,96000,,,,60468,3365041000,55649.94707944698,45038,2208229000,49030.352147075806,15430,1156812000
2022,total,48453,Travis,96000,,,,82255,7568765000,92015.86529694243,91606,6441696000,70319.58605331529,-9351,1127069000
2022,total,48209,Hays,96000,,,,24182,1427754000,59042.01472169382,16637,763735000,45905.812345975835,7545,664019000
2022,total,48091,Comal,96000,,,,20441,1157728000,56637.542194608875,12335,561165000,45493.71706526145,8106,596563000
2022,total,48029,Bexar,96000,,,,89165,3201155000,35901.474793921385,79530,3341062000,42010.08424493902,9635,-139907000
